"country","region","c_t","year","pr","cl","total"
"Abkhazia","Eurasia","t",2022,17,23,40
"Afghanistan","Asia","c",2022,1,9,10
"Albania","Europe","c",2022,28,39,67
"Algeria","Africa","c",2022,10,22,32
"Andorra","Europe","c",2022,38,55,93
"Angola","Africa","c",2022,10,20,30
"Antigua and Barbuda","Americas","c",2022,33,52,85
"Argentina","Americas","c",2022,35,49,84
"Armenia","Eurasia","c",2022,23,32,55
"Australia","Asia","c",2022,39,56,95
"Austria","Europe","c",2022,37,56,93
"Azerbaijan","Eurasia","c",2022,2,7,9
"Bahamas","Americas","c",2022,38,53,91
"Bahrain","Middle East","c",2022,2,10,12
"Bangladesh","Asia","c",2022,15,24,39
"Barbados","Americas","c",2022,38,57,95
"Belarus","Eurasia","c",2022,2,6,8
"Belgium","Europe","c",2022,39,57,96
"Belize","Americas","c",2022,34,53,87
"Benin","Africa","c",2022,17,42,59
"Bhutan","Asia","c",2022,29,32,61
"Bolivia","Americas","c",2022,27,39,66
"Bosnia and Herzegovina","Europe","c",2022,19,34,53
"Botswana","Africa","c",2022,28,44,72
"Brazil","Americas","c",2022,31,42,73
"Brunei","Asia","c",2022,7,21,28
"Bulgaria","Europe","c",2022,33,46,79
"Burkina Faso","Africa","c",2022,23,30,53
"Burundi","Africa","c",2022,4,10,14
"Cabo Verde","Africa","c",2022,38,54,92
"Cambodia","Asia","c",2022,5,19,24
"Cameroon","Africa","c",2022,6,9,15
"Canada","Americas","c",2022,40,58,98
"Central African Republic","Africa","c",2022,3,4,7
"Chad","Africa","c",2022,1,14,15
"Chile","Americas","c",2022,38,56,94
"China","Asia","c",2022,-2,11,9
"Colombia","Americas","c",2022,29,35,64
"Comoros","Africa","c",2022,16,26,42
"Congo (Brazzaville)","Africa","c",2022,2,15,17
"Congo (Kinshasa)","Africa","c",2022,4,15,19
"Costa Rica","Americas","c",2022,38,53,91
"Cote d'Ivoire","Africa","c",2022,19,30,49
"Crimea","Eurasia","t",2022,-2,9,7
"Croatia","Europe","c",2022,36,49,85
"Cuba","Americas","c",2022,1,11,12
"Cyprus","Europe","c",2022,38,55,93
"Czech Republic","Europe","c",2022,36,55,91
"Denmark","Europe","c",2022,40,57,97
"Djibouti","Africa","c",2022,5,19,24
"Dominica","Americas","c",2022,37,56,93
"Dominican Republic","Americas","c",2022,27,41,68
"Eastern Donbas","Eurasia","t",2022,-1,5,4
"Ecuador","Americas","c",2022,31,40,71
"Egypt","Africa","c",2022,6,12,18
"El Salvador","Americas","c",2022,26,33,59
"Equatorial Guinea","Africa","c",2022,0,5,5
"Eritrea","Africa","c",2022,1,2,3
"Estonia","Europe","c",2022,38,56,94
"Eswatini","Africa","c",2022,1,16,17
"Ethiopia","Africa","c",2022,12,11,23
"Fiji","Asia","c",2022,23,35,58
"Finland","Europe","c",2022,40,60,100
"France","Europe","c",2022,38,51,89
"Gabon","Africa","c",2022,3,18,21
"Gaza Strip","Middle East","t",2022,3,8,11
"Georgia","Eurasia","c",2022,22,36,58
"Germany","Europe","c",2022,39,55,94
"Ghana","Africa","c",2022,35,45,80
"Greece","Europe","c",2022,37,50,87
"Grenada","Americas","c",2022,37,52,89
"Guatemala","Americas","c",2022,21,30,51
"Guinea","Africa","c",2022,10,24,34
"Guinea-Bissau","Africa","c",2022,17,26,43
"Guyana","Americas","c",2022,30,43,73
"Haiti","Americas","c",2022,11,22,33
"Honduras","Americas","c",2022,21,26,47
"Hong Kong","Asia","t",2022,10,33,43
"Hungary","Europe","c",2022,26,43,69
"Iceland","Europe","c",2022,37,57,94
"India","Asia","c",2022,33,33,66
"Indian Kashmir","Asia","t",2022,7,20,27
"Indonesia","Asia","c",2022,30,29,59
"Iran","Middle East","c",2022,4,10,14
"Iraq","Middle East","c",2022,16,13,29
"Ireland","Europe","c",2022,39,58,97
"Israel","Middle East","c",2022,34,42,76
"Italy","Europe","c",2022,36,54,90
"Jamaica","Americas","c",2022,34,46,80
"Japan","Asia","c",2022,40,56,96
"Jordan","Middle East","c",2022,11,22,33
"Kazakhstan","Eurasia","c",2022,5,18,23
"Kenya","Africa","c",2022,19,29,48
"Kiribati","Asia","c",2022,37,56,93
"Kosovo","Europe","c",2022,25,31,56
"Kuwait","Middle East","c",2022,14,23,37
"Kyrgyzstan","Eurasia","c",2022,4,23,27
"Laos","Asia","c",2022,2,11,13
"Latvia","Europe","c",2022,37,51,88
"Lebanon","Middle East","c",2022,13,29,42
"Lesotho","Africa","c",2022,27,36,63
"Liberia","Africa","c",2022,27,33,60
"Libya","Africa","c",2022,1,8,9
"Liechtenstein","Europe","c",2022,33,57,90
"Lithuania","Europe","c",2022,38,51,89
"Luxembourg","Europe","c",2022,38,59,97
"Madagascar","Africa","c",2022,27,34,61
"Malawi","Africa","c",2022,29,37,66
"Malaysia","Asia","c",2022,20,30,50
"Maldives","Asia","c",2022,19,21,40
"Mali","Africa","c",2022,8,24,32
"Malta","Europe","c",2022,35,54,89
"Marshall Islands","Asia","c",2022,38,55,93
"Mauritania","Africa","c",2022,14,21,35
"Mauritius","Africa","c",2022,36,50,86
"Mexico","Americas","c",2022,27,33,60
"Micronesia","Asia","c",2022,37,55,92
"Moldova","Eurasia","c",2022,27,35,62
"Monaco","Europe","c",2022,27,57,84
"Mongolia","Asia","c",2022,36,48,84
"Montenegro","Europe","c",2022,26,41,67
"Morocco","Africa","c",2022,13,24,37
"Mozambique","Africa","c",2022,14,29,43
"Myanmar","Asia","c",2022,0,9,9
"Nagorno-Karabakh","Eurasia","t",2022,16,20,36
"Namibia","Africa","c",2022,31,46,77
"Nauru","Asia","c",2022,34,43,77
"Nepal","Asia","c",2022,25,32,57
"Netherlands","Europe","c",2022,39,58,97
"New Zealand","Asia","c",2022,40,59,99
"Nicaragua","Americas","c",2022,5,18,23
"Niger","Africa","c",2022,23,28,51
"Nigeria","Africa","c",2022,20,23,43
"North Korea","Asia","c",2022,0,3,3
"North Macedonia","Europe","c",2022,28,39,67
"Northern Cyprus","Europe","t",2022,27,50,77
"Norway","Europe","c",2022,40,60,100
"Oman","Middle East","c",2022,6,18,24
"Pakistan","Asia","c",2022,15,22,37
"Pakistani Kashmir","Asia","t",2022,9,20,29
"Palau","Asia","c",2022,37,55,92
"Panama","Americas","c",2022,35,48,83
"Papua New Guinea","Asia","c",2022,23,39,62
"Paraguay","Americas","c",2022,28,37,65
"Peru","Americas","c",2022,30,42,72
"Philippines","Asia","c",2022,25,30,55
"Poland","Europe","c",2022,34,47,81
"Portugal","Europe","c",2022,39,56,95
"Qatar","Middle East","c",2022,7,18,25
"Romania","Europe","c",2022,35,48,83
"Russia","Eurasia","c",2022,5,14,19
"Rwanda","Africa","c",2022,8,14,22
"Samoa","Asia","c",2022,32,51,83
"San Marino","Europe","c",2022,38,55,93
"Sao Tome and Principe","Africa","c",2022,35,49,84
"Saudi Arabia","Middle East","c",2022,1,6,7
"Senegal","Africa","c",2022,29,39,68
"Serbia","Europe","c",2022,21,41,62
"Seychelles","Africa","c",2022,34,45,79
"Sierra Leone","Africa","c",2022,28,37,65
"Singapore","Asia","c",2022,19,28,47
"Slovakia","Europe","c",2022,37,53,90
"Slovenia","Europe","c",2022,38,52,90
"Solomon Islands","Asia","c",2022,30,49,79
"Somalia","Africa","c",2022,1,6,7
"Somaliland","Africa","t",2022,22,27,49
"South Africa","Africa","c",2022,33,46,79
"South Korea","Asia","c",2022,33,50,83
"South Ossetia","Eurasia","t",2022,2,9,11
"South Sudan","Africa","c",2022,-3,4,1
"Spain","Europe","c",2022,37,53,90
"Sri Lanka","Asia","c",2022,23,32,55
"St. Kitts and Nevis","Americas","c",2022,35,54,89
"St. Lucia","Americas","c",2022,38,54,92
"St. Vincent and the Grenadines","Americas","c",2022,36,55,91
"Sudan","Africa","c",2022,0,10,10
"Suriname","Americas","c",2022,34,45,79
"Sweden","Europe","c",2022,40,60,100
"Switzerland","Europe","c",2022,39,57,96
"Syria","Middle East","c",2022,-3,4,1
"Taiwan","Asia","c",2022,38,56,94
"Tajikistan","Eurasia","c",2022,0,8,8
"Tanzania","Africa","c",2022,12,22,34
"Thailand","Asia","c",2022,5,24,29
"The Gambia","Africa","c",2022,21,26,47
"Tibet","Asia","t",2022,-2,3,1
"Timor-Leste","Asia","c",2022,33,39,72
"Togo","Africa","c",2022,15,27,42
"Tonga","Asia","c",2022,30,49,79
"Transnistria","Eurasia","t",2022,6,12,18
"Trinidad and Tobago","Americas","c",2022,33,49,82
"Tunisia","Africa","c",2022,26,38,64
"Turkey","Europe","c",2022,16,16,32
"Turkmenistan","Eurasia","c",2022,0,2,2
"Tuvalu","Asia","c",2022,37,56,93
"Uganda","Africa","c",2022,11,23,34
"Ukraine","Eurasia","c",2022,26,35,61
"United Arab Emirates","Middle East","c",2022,5,12,17
"United Kingdom","Europe","c",2022,39,54,93
"United States","Americas","c",2022,32,51,83
"Uruguay","Americas","c",2022,40,57,97
"Uzbekistan","Eurasia","c",2022,2,9,11
"Vanuatu","Asia","c",2022,33,49,82
"Venezuela","Americas","c",2022,1,13,14
"Vietnam","Asia","c",2022,3,16,19
"West Bank","Middle East","t",2022,4,19,23
"Western Sahara","Africa","t",2022,-3,7,4
"Yemen","Middle East","c",2022,1,8,9
"Zambia","Africa","c",2022,21,30,51
"Zimbabwe","Africa","c",2022,11,17,28
"Abkhazia","Eurasia","t",2021,17,23,40
"Afghanistan","Asia","c",2021,13,14,27
"Albania","Europe","c",2021,27,39,66
"Algeria","Africa","c",2021,10,22,32
"Andorra","Europe","c",2021,38,55,93
"Angola","Africa","c",2021,10,21,31
"Antigua and Barbuda","Americas","c",2021,33,52,85
"Argentina","Americas","c",2021,35,49,84
"Armenia","Eurasia","c",2021,22,33,55
"Australia","Asia","c",2021,40,57,97
"Austria","Europe","c",2021,37,56,93
"Azerbaijan","Eurasia","c",2021,2,8,10
"Bahamas","Americas","c",2021,38,53,91
"Bahrain","Middle East","c",2021,2,10,12
"Bangladesh","Asia","c",2021,15,24,39
"Barbados","Americas","c",2021,38,57,95
"Belarus","Eurasia","c",2021,2,9,11
"Belgium","Europe","c",2021,39,57,96
"Belize","Americas","c",2021,34,53,87
"Benin","Africa","c",2021,21,44,65
"Bhutan","Asia","c",2021,30,31,61
"Bolivia","Americas","c",2021,27,39,66
"Bosnia and Herzegovina","Europe","c",2021,19,34,53
"Botswana","Africa","c",2021,28,44,72
"Brazil","Americas","c",2021,31,43,74
"Brunei","Asia","c",2021,7,21,28
"Bulgaria","Europe","c",2021,33,45,78
"Burkina Faso","Africa","c",2021,23,31,54
"Burundi","Africa","c",2021,4,10,14
"Cabo Verde","Africa","c",2021,38,54,92
"Cambodia","Asia","c",2021,5,19,24
"Cameroon","Africa","c",2021,7,9,16
"Canada","Americas","c",2021,40,58,98
"Central African Republic","Africa","c",2021,3,6,9
"Chad","Africa","c",2021,3,14,17
"Chile","Americas","c",2021,38,55,93
"China","Asia","c",2021,-2,11,9
"Colombia","Americas","c",2021,29,36,65
"Comoros","Africa","c",2021,16,26,42
"Congo (Brazzaville)","Africa","c",2021,2,18,20
"Congo (Kinshasa)","Africa","c",2021,5,15,20
"Costa Rica","Americas","c",2021,38,53,91
"Cote d'Ivoire","Africa","c",2021,16,28,44
"Crimea","Eurasia","t",2021,-2,9,7
"Croatia","Europe","c",2021,36,49,85
"Cuba","Americas","c",2021,1,12,13
"Cyprus","Europe","c",2021,38,56,94
"Czech Republic","Europe","c",2021,36,55,91
"Denmark","Europe","c",2021,40,57,97
"Djibouti","Africa","c",2021,5,19,24
"Dominica","Americas","c",2021,37,56,93
"Dominican Republic","Americas","c",2021,26,41,67
"Eastern Donbas","Eurasia","t",2021,-1,5,4
"Ecuador","Americas","c",2021,27,40,67
"Egypt","Africa","c",2021,6,12,18
"El Salvador","Americas","c",2021,30,33,63
"Equatorial Guinea","Africa","c",2021,0,5,5
"Eritrea","Africa","c",2021,1,1,2
"Estonia","Europe","c",2021,38,56,94
"Eswatini","Africa","c",2021,1,18,19
"Ethiopia","Africa","c",2021,9,13,22
"Fiji","Asia","c",2021,24,36,60
"Finland","Europe","c",2021,40,60,100
"France","Europe","c",2021,38,52,90
"Gabon","Africa","c",2021,3,19,22
"Gaza Strip","Middle East","t",2021,3,8,11
"Georgia","Eurasia","c",2021,23,37,60
"Germany","Europe","c",2021,39,55,94
"Ghana","Africa","c",2021,35,47,82
"Greece","Europe","c",2021,37,50,87
"Grenada","Americas","c",2021,37,52,89
"Guatemala","Americas","c",2021,21,31,52
"Guinea","Africa","c",2021,14,24,38
"Guinea-Bissau","Africa","c",2021,17,27,44
"Guyana","Americas","c",2021,30,43,73
"Haiti","Americas","c",2021,15,22,37
"Honduras","Americas","c",2021,19,25,44
"Hong Kong","Asia","t",2021,15,37,52
"Hungary","Europe","c",2021,26,43,69
"Iceland","Europe","c",2021,37,57,94
"India","Asia","c",2021,34,33,67
"Indian Kashmir","Asia","t",2021,7,20,27
"Indonesia","Asia","c",2021,30,29,59
"Iran","Middle East","c",2021,6,10,16
"Iraq","Middle East","c",2021,16,13,29
"Ireland","Europe","c",2021,39,58,97
"Israel","Middle East","c",2021,33,43,76
"Italy","Europe","c",2021,36,54,90
"Jamaica","Americas","c",2021,34,46,80
"Japan","Asia","c",2021,40,56,96
"Jordan","Middle East","c",2021,11,23,34
"Kazakhstan","Eurasia","c",2021,5,18,23
"Kenya","Africa","c",2021,19,29,48
"Kiribati","Asia","c",2021,37,56,93
"Kosovo","Europe","c",2021,23,31,54
"Kuwait","Middle East","c",2021,14,23,37
"Kyrgyzstan","Eurasia","c",2021,4,24,28
"Laos","Asia","c",2021,2,11,13
"Latvia","Europe","c",2021,37,52,89
"Lebanon","Middle East","c",2021,13,30,43
"Lesotho","Africa","c",2021,27,36,63
"Liberia","Africa","c",2021,27,33,60
"Libya","Africa","c",2021,1,8,9
"Liechtenstein","Europe","c",2021,33,57,90
"Lithuania","Europe","c",2021,38,52,90
"Luxembourg","Europe","c",2021,38,59,97
"Madagascar","Africa","c",2021,27,33,60
"Malawi","Africa","c",2021,29,37,66
"Malaysia","Asia","c",2021,21,30,51
"Maldives","Asia","c",2021,19,21,40
"Mali","Africa","c",2021,9,24,33
"Malta","Europe","c",2021,35,55,90
"Marshall Islands","Asia","c",2021,38,55,93
"Mauritania","Africa","c",2021,14,21,35
"Mauritius","Africa","c",2021,37,50,87
"Mexico","Americas","c",2021,27,34,61
"Micronesia","Asia","c",2021,37,55,92
"Moldova","Eurasia","c",2021,26,35,61
"Monaco","Europe","c",2021,26,57,83
"Mongolia","Asia","c",2021,36,48,84
"Montenegro","Europe","c",2021,24,39,63
"Morocco","Africa","c",2021,13,24,37
"Mozambique","Africa","c",2021,14,29,43
"Myanmar","Asia","c",2021,13,15,28
"Nagorno-Karabakh","Eurasia","t",2021,16,19,35
"Namibia","Africa","c",2021,31,46,77
"Nauru","Asia","c",2021,34,43,77
"Nepal","Asia","c",2021,25,31,56
"Netherlands","Europe","c",2021,40,58,98
"New Zealand","Asia","c",2021,40,59,99
"Nicaragua","Americas","c",2021,10,20,30
"Niger","Africa","c",2021,20,28,48
"Nigeria","Africa","c",2021,21,24,45
"North Korea","Asia","c",2021,0,3,3
"North Macedonia","Europe","c",2021,27,39,66
"Northern Cyprus","Europe","t",2021,28,50,78
"Norway","Europe","c",2021,40,60,100
"Oman","Middle East","c",2021,6,17,23
"Pakistan","Asia","c",2021,15,22,37
"Pakistani Kashmir","Asia","t",2021,9,19,28
"Palau","Asia","c",2021,37,55,92
"Panama","Americas","c",2021,35,48,83
"Papua New Guinea","Asia","c",2021,23,39,62
"Paraguay","Americas","c",2021,28,37,65
"Peru","Americas","c",2021,29,42,71
"Philippines","Asia","c",2021,25,31,56
"Poland","Europe","c",2021,34,48,82
"Portugal","Europe","c",2021,39,57,96
"Qatar","Middle East","c",2021,7,18,25
"Romania","Europe","c",2021,35,48,83
"Russia","Eurasia","c",2021,5,15,20
"Rwanda","Africa","c",2021,8,13,21
"Samoa","Asia","c",2021,30,51,81
"San Marino","Europe","c",2021,38,55,93
"Sao Tome and Principe","Africa","c",2021,35,49,84
"Saudi Arabia","Middle East","c",2021,1,6,7
"Senegal","Africa","c",2021,29,42,71
"Serbia","Europe","c",2021,22,42,64
"Seychelles","Africa","c",2021,34,43,77
"Sierra Leone","Africa","c",2021,28,37,65
"Singapore","Asia","c",2021,19,29,48
"Slovakia","Europe","c",2021,37,53,90
"Slovenia","Europe","c",2021,39,56,95
"Solomon Islands","Asia","c",2021,30,49,79
"Somalia","Africa","c",2021,1,6,7
"Somaliland","Africa","t",2021,18,24,42
"South Africa","Africa","c",2021,33,46,79
"South Korea","Asia","c",2021,33,50,83
"South Ossetia","Eurasia","t",2021,2,8,10
"South Sudan","Africa","c",2021,-2,4,2
"Spain","Europe","c",2021,37,53,90
"Sri Lanka","Asia","c",2021,23,33,56
"St. Kitts and Nevis","Americas","c",2021,35,54,89
"St. Lucia","Americas","c",2021,37,54,91
"St. Vincent and the Grenadines","Americas","c",2021,36,55,91
"Sudan","Africa","c",2021,2,15,17
"Suriname","Americas","c",2021,34,45,79
"Sweden","Europe","c",2021,40,60,100
"Switzerland","Europe","c",2021,39,57,96
"Syria","Middle East","c",2021,-3,4,1
"Taiwan","Asia","c",2021,38,56,94
"Tajikistan","Eurasia","c",2021,0,8,8
"Tanzania","Africa","c",2021,12,22,34
"Thailand","Asia","c",2021,5,25,30
"The Gambia","Africa","c",2021,20,26,46
"Tibet","Asia","t",2021,-2,3,1
"Timor-Leste","Asia","c",2021,33,39,72
"Togo","Africa","c",2021,15,28,43
"Tonga","Asia","c",2021,30,49,79
"Transnistria","Eurasia","t",2021,8,12,20
"Trinidad and Tobago","Americas","c",2021,33,49,82
"Tunisia","Africa","c",2021,32,39,71
"Turkey","Europe","c",2021,16,16,32
"Turkmenistan","Eurasia","c",2021,0,2,2
"Tuvalu","Asia","c",2021,37,56,93
"Uganda","Africa","c",2021,11,23,34
"Ukraine","Eurasia","c",2021,26,34,60
"United Arab Emirates","Middle East","c",2021,5,12,17
"United Kingdom","Europe","c",2021,39,54,93
"United States","Americas","c",2021,32,51,83
"Uruguay","Americas","c",2021,40,58,98
"Uzbekistan","Eurasia","c",2021,2,9,11
"Vanuatu","Asia","c",2021,33,49,82
"Venezuela","Americas","c",2021,1,13,14
"Vietnam","Asia","c",2021,3,16,19
"West Bank","Middle East","t",2021,4,21,25
"Western Sahara","Africa","t",2021,-3,7,4
"Yemen","Middle East","c",2021,1,10,11
"Zambia","Africa","c",2021,20,32,52
"Zimbabwe","Africa","c",2021,11,17,28
"Abkhazia","Eurasia","t",2020,17,23,40
"Afghanistan","Asia","c",2020,13,14,27
"Albania","Europe","c",2020,27,40,67
"Algeria","Africa","c",2020,10,24,34
"Andorra","Europe","c",2020,39,55,94
"Angola","Africa","c",2020,11,21,32
"Antigua and Barbuda","Americas","c",2020,33,52,85
"Argentina","Americas","c",2020,35,50,85
"Armenia","Eurasia","c",2020,21,32,53
"Australia","Asia","c",2020,40,57,97
"Austria","Europe","c",2020,37,56,93
"Azerbaijan","Eurasia","c",2020,2,8,10
"Bahamas","Americas","c",2020,38,53,91
"Bahrain","Middle East","c",2020,1,10,11
"Bangladesh","Asia","c",2020,15,24,39
"Barbados","Americas","c",2020,38,57,95
"Belarus","Eurasia","c",2020,5,14,19
"Belgium","Europe","c",2020,39,57,96
"Belize","Americas","c",2020,35,51,86
"Benin","Africa","c",2020,21,45,66
"Bhutan","Asia","c",2020,29,30,59
"Bolivia","Americas","c",2020,25,38,63
"Bosnia and Herzegovina","Europe","c",2020,19,34,53
"Botswana","Africa","c",2020,28,44,72
"Brazil","Americas","c",2020,31,44,75
"Brunei","Asia","c",2020,7,21,28
"Bulgaria","Europe","c",2020,34,46,80
"Burkina Faso","Africa","c",2020,23,33,56
"Burundi","Africa","c",2020,3,10,13
"Cabo Verde","Africa","c",2020,38,54,92
"Cambodia","Asia","c",2020,5,20,25
"Cameroon","Africa","c",2020,7,11,18
"Canada","Americas","c",2020,40,58,98
"Central African Republic","Africa","c",2020,4,6,10
"Chad","Africa","c",2020,3,14,17
"Chile","Americas","c",2020,38,52,90
"China","Asia","c",2020,-1,11,10
"Colombia","Americas","c",2020,29,37,66
"Comoros","Africa","c",2020,18,26,44
"Congo (Brazzaville)","Africa","c",2020,2,18,20
"Congo (Kinshasa)","Africa","c",2020,4,14,18
"Costa Rica","Americas","c",2020,38,53,91
"Cote d'Ivoire","Africa","c",2020,19,32,51
"Crimea","Eurasia","t",2020,-2,10,8
"Croatia","Europe","c",2020,36,49,85
"Cuba","Americas","c",2020,1,13,14
"Cyprus","Europe","c",2020,38,56,94
"Czech Republic","Europe","c",2020,36,55,91
"Denmark","Europe","c",2020,40,57,97
"Djibouti","Africa","c",2020,5,19,24
"Dominica","Americas","c",2020,37,56,93
"Dominican Republic","Americas","c",2020,26,41,67
"Eastern Donbas","Eurasia","t",2020,-1,6,5
"Ecuador","Americas","c",2020,27,38,65
"Egypt","Africa","c",2020,7,14,21
"El Salvador","Americas","c",2020,32,34,66
"Equatorial Guinea","Africa","c",2020,0,6,6
"Eritrea","Africa","c",2020,1,1,2
"Estonia","Europe","c",2020,38,56,94
"Eswatini","Africa","c",2020,1,18,19
"Ethiopia","Africa","c",2020,10,14,24
"Fiji","Asia","c",2020,24,36,60
"Finland","Europe","c",2020,40,60,100
"France","Europe","c",2020,38,52,90
"Gabon","Africa","c",2020,3,19,22
"Gaza Strip","Middle East","t",2020,3,8,11
"Georgia","Eurasia","c",2020,24,37,61
"Germany","Europe","c",2020,39,55,94
"Ghana","Africa","c",2020,35,47,82
"Greece","Europe","c",2020,37,51,88
"Grenada","Americas","c",2020,37,52,89
"Guatemala","Americas","c",2020,21,31,52
"Guinea","Africa","c",2020,15,25,40
"Guinea-Bissau","Africa","c",2020,17,29,46
"Guyana","Americas","c",2020,31,43,74
"Haiti","Americas","c",2020,16,22,38
"Honduras","Americas","c",2020,19,26,45
"Hong Kong","Asia","t",2020,16,39,55
"Hungary","Europe","c",2020,27,43,70
"Iceland","Europe","c",2020,37,57,94
"India","Asia","c",2020,34,37,71
"Indian Kashmir","Asia","t",2020,8,20,28
"Indonesia","Asia","c",2020,30,31,61
"Iran","Middle East","c",2020,7,10,17
"Iraq","Middle East","c",2020,17,14,31
"Ireland","Europe","c",2020,39,58,97
"Israel","Middle East","c",2020,33,43,76
"Italy","Europe","c",2020,36,53,89
"Jamaica","Americas","c",2020,34,44,78
"Japan","Asia","c",2020,40,56,96
"Jordan","Middle East","c",2020,12,25,37
"Kazakhstan","Eurasia","c",2020,5,18,23
"Kenya","Africa","c",2020,19,29,48
"Kiribati","Asia","c",2020,37,56,93
"Kosovo","Europe","c",2020,25,31,56
"Kuwait","Middle East","c",2020,13,23,36
"Kyrgyzstan","Eurasia","c",2020,12,27,39
"Laos","Asia","c",2020,2,12,14
"Latvia","Europe","c",2020,37,52,89
"Lebanon","Middle East","c",2020,14,30,44
"Lesotho","Africa","c",2020,27,36,63
"Liberia","Africa","c",2020,27,33,60
"Libya","Africa","c",2020,1,8,9
"Liechtenstein","Europe","c",2020,33,57,90
"Lithuania","Europe","c",2020,38,53,91
"Luxembourg","Europe","c",2020,38,60,98
"Madagascar","Africa","c",2020,26,35,61
"Malawi","Africa","c",2020,26,36,62
"Malaysia","Asia","c",2020,21,31,52
"Maldives","Asia","c",2020,18,22,40
"Mali","Africa","c",2020,17,24,41
"Malta","Europe","c",2020,35,55,90
"Marshall Islands","Asia","c",2020,38,55,93
"Mauritania","Africa","c",2020,13,21,34
"Mauritius","Africa","c",2020,37,52,89
"Mexico","Americas","c",2020,27,35,62
"Micronesia","Asia","c",2020,37,55,92
"Moldova","Eurasia","c",2020,26,34,60
"Monaco","Europe","c",2020,26,57,83
"Mongolia","Asia","c",2020,36,48,84
"Montenegro","Europe","c",2020,22,40,62
"Morocco","Africa","c",2020,13,24,37
"Mozambique","Africa","c",2020,14,31,45
"Myanmar","Asia","c",2020,14,16,30
"Nagorno-Karabakh","Eurasia","t",2020,13,21,34
"Namibia","Africa","c",2020,31,46,77
"Nauru","Asia","c",2020,34,43,77
"Nepal","Asia","c",2020,25,31,56
"Netherlands","Europe","c",2020,40,59,99
"New Zealand","Asia","c",2020,40,57,97
"Nicaragua","Americas","c",2020,10,21,31
"Niger","Africa","c",2020,20,28,48
"Nigeria","Africa","c",2020,22,25,47
"North Korea","Asia","c",2020,0,3,3
"North Macedonia","Europe","c",2020,24,39,63
"Northern Cyprus","Europe","t",2020,31,50,81
"Norway","Europe","c",2020,40,60,100
"Oman","Middle East","c",2020,6,17,23
"Pakistan","Asia","c",2020,16,22,38
"Pakistani Kashmir","Asia","t",2020,9,19,28
"Palau","Asia","c",2020,37,55,92
"Panama","Americas","c",2020,36,48,84
"Papua New Guinea","Asia","c",2020,23,39,62
"Paraguay","Americas","c",2020,28,37,65
"Peru","Americas","c",2020,30,42,72
"Philippines","Asia","c",2020,25,34,59
"Poland","Europe","c",2020,35,49,84
"Portugal","Europe","c",2020,39,57,96
"Qatar","Middle East","c",2020,7,18,25
"Romania","Europe","c",2020,35,48,83
"Russia","Eurasia","c",2020,5,15,20
"Rwanda","Africa","c",2020,8,14,22
"Samoa","Asia","c",2020,30,51,81
"San Marino","Europe","c",2020,38,57,95
"Sao Tome and Principe","Africa","c",2020,35,49,84
"Saudi Arabia","Middle East","c",2020,1,6,7
"Senegal","Africa","c",2020,29,42,71
"Serbia","Europe","c",2020,23,43,66
"Seychelles","Africa","c",2020,29,43,72
"Sierra Leone","Africa","c",2020,28,37,65
"Singapore","Asia","c",2020,19,31,50
"Slovakia","Europe","c",2020,36,52,88
"Slovenia","Europe","c",2020,39,55,94
"Solomon Islands","Asia","c",2020,30,49,79
"Somalia","Africa","c",2020,1,6,7
"Somaliland","Africa","t",2020,17,24,41
"South Africa","Africa","c",2020,33,46,79
"South Korea","Asia","c",2020,33,50,83
"South Ossetia","Eurasia","t",2020,2,8,10
"South Sudan","Africa","c",2020,-2,4,2
"Spain","Europe","c",2020,38,54,92
"Sri Lanka","Asia","c",2020,23,33,56
"St. Kitts and Nevis","Americas","c",2020,36,53,89
"St. Lucia","Americas","c",2020,38,54,92
"St. Vincent and the Grenadines","Americas","c",2020,36,55,91
"Sudan","Africa","c",2020,2,10,12
"Suriname","Americas","c",2020,32,43,75
"Sweden","Europe","c",2020,40,60,100
"Switzerland","Europe","c",2020,39,57,96
"Syria","Middle East","c",2020,-3,3,0
"Taiwan","Asia","c",2020,37,56,93
"Tajikistan","Eurasia","c",2020,0,9,9
"Tanzania","Africa","c",2020,17,23,40
"Thailand","Asia","c",2020,6,26,32
"The Gambia","Africa","c",2020,20,26,46
"Tibet","Asia","t",2020,-2,3,1
"Timor-Leste","Asia","c",2020,32,39,71
"Togo","Africa","c",2020,16,28,44
"Tonga","Asia","c",2020,30,49,79
"Transnistria","Eurasia","t",2020,9,13,22
"Trinidad and Tobago","Americas","c",2020,33,49,82
"Tunisia","Africa","c",2020,32,38,70
"Turkey","Europe","c",2020,16,16,32
"Turkmenistan","Eurasia","c",2020,0,2,2
"Tuvalu","Asia","c",2020,37,56,93
"Uganda","Africa","c",2020,11,23,34
"Ukraine","Eurasia","c",2020,27,35,62
"United Arab Emirates","Middle East","c",2020,5,12,17
"United Kingdom","Europe","c",2020,39,55,94
"United States","Americas","c",2020,33,53,86
"Uruguay","Americas","c",2020,40,58,98
"Uzbekistan","Eurasia","c",2020,2,8,10
"Vanuatu","Asia","c",2020,33,49,82
"Venezuela","Americas","c",2020,2,14,16
"Vietnam","Asia","c",2020,3,17,20
"West Bank","Middle East","t",2020,4,21,25
"Western Sahara","Africa","t",2020,-3,7,4
"Yemen","Middle East","c",2020,1,10,11
"Zambia","Africa","c",2020,22,32,54
"Zimbabwe","Africa","c",2020,12,17,29
"Abkhazia","Eurasia","t",2019,18,23,41
"Afghanistan","Asia","c",2019,13,14,27
"Albania","Europe","c",2019,28,40,68
"Algeria","Africa","c",2019,10,24,34
"Andorra","Europe","c",2019,39,55,94
"Angola","Africa","c",2019,11,20,31
"Antigua and Barbuda","Americas","c",2019,33,51,84
"Argentina","Americas","c",2019,34,50,84
"Armenia","Eurasia","c",2019,20,31,51
"Australia","Asia","c",2019,40,58,98
"Austria","Europe","c",2019,37,56,93
"Azerbaijan","Eurasia","c",2019,2,9,11
"Bahamas","Americas","c",2019,38,53,91
"Bahrain","Middle East","c",2019,2,10,12
"Bangladesh","Asia","c",2019,17,24,41
"Barbados","Americas","c",2019,38,58,96
"Belarus","Eurasia","c",2019,5,14,19
"Belgium","Europe","c",2019,39,57,96
"Belize","Americas","c",2019,36,50,86
"Benin","Africa","c",2019,32,47,79
"Bhutan","Asia","c",2019,29,30,59
"Bolivia","Americas","c",2019,28,39,67
"Bosnia and Herzegovina","Europe","c",2019,19,34,53
"Botswana","Africa","c",2019,28,44,72
"Brazil","Americas","c",2019,30,45,75
"Brunei","Asia","c",2019,7,22,29
"Bulgaria","Europe","c",2019,33,47,80
"Burkina Faso","Africa","c",2019,23,37,60
"Burundi","Africa","c",2019,3,11,14
"Cabo Verde","Africa","c",2019,37,53,90
"Cambodia","Asia","c",2019,6,20,26
"Cameroon","Africa","c",2019,7,12,19
"Canada","Americas","c",2019,40,59,99
"Central African Republic","Africa","c",2019,4,5,9
"Chad","Africa","c",2019,3,14,17
"Chile","Americas","c",2019,37,57,94
"China","Asia","c",2019,-1,12,11
"Colombia","Americas","c",2019,29,37,66
"Comoros","Africa","c",2019,21,29,50
"Congo (Brazzaville)","Africa","c",2019,2,19,21
"Congo (Kinshasa)","Africa","c",2019,3,12,15
"Costa Rica","Americas","c",2019,38,53,91
"Cote d'Ivoire","Africa","c",2019,19,32,51
"Crimea","Eurasia","t",2019,-2,10,8
"Croatia","Europe","c",2019,36,49,85
"Cuba","Americas","c",2019,1,13,14
"Cyprus","Europe","c",2019,38,56,94
"Czech Republic","Europe","c",2019,36,55,91
"Denmark","Europe","c",2019,40,57,97
"Djibouti","Africa","c",2019,7,19,26
"Dominica","Americas","c",2019,37,56,93
"Dominican Republic","Americas","c",2019,26,41,67
"Ecuador","Americas","c",2019,25,38,63
"Egypt","Africa","c",2019,8,14,22
"El Salvador","Americas","c",2019,32,35,67
"Equatorial Guinea","Africa","c",2019,0,6,6
"Eritrea","Africa","c",2019,1,1,2
"Estonia","Europe","c",2019,38,56,94
"Eswatini","Africa","c",2019,1,15,16
"Ethiopia","Africa","c",2019,7,12,19
"Fiji","Asia","c",2019,24,37,61
"Finland","Europe","c",2019,40,60,100
"France","Europe","c",2019,38,52,90
"Gabon","Africa","c",2019,4,19,23
"Gaza Strip","Middle East","t",2019,3,8,11
"Georgia","Eurasia","c",2019,25,38,63
"Germany","Europe","c",2019,39,55,94
"Ghana","Africa","c",2019,36,47,83
"Greece","Europe","c",2019,36,51,87
"Grenada","Americas","c",2019,37,52,89
"Guatemala","Americas","c",2019,22,31,53
"Guinea","Africa","c",2019,17,26,43
"Guinea-Bissau","Africa","c",2019,15,27,42
"Guyana","Americas","c",2019,32,43,75
"Haiti","Americas","c",2019,17,24,41
"Honduras","Americas","c",2019,20,26,46
"Hong Kong","Asia","t",2019,15,44,59
"Hungary","Europe","c",2019,27,43,70
"Iceland","Europe","c",2019,37,57,94
"India","Asia","c",2019,35,40,75
"Indian Kashmir","Asia","t",2019,22,27,49
"Indonesia","Asia","c",2019,30,32,62
"Iran","Middle East","c",2019,7,11,18
"Iraq","Middle East","c",2019,17,15,32
"Ireland","Europe","c",2019,39,58,97
"Israel","Middle East","c",2019,35,43,78
"Italy","Europe","c",2019,36,53,89
"Jamaica","Americas","c",2019,34,44,78
"Japan","Asia","c",2019,40,56,96
"Jordan","Middle East","c",2019,12,25,37
"Kazakhstan","Eurasia","c",2019,5,17,22
"Kenya","Africa","c",2019,19,29,48
"Kiribati","Asia","c",2019,37,56,93
"Kosovo","Europe","c",2019,24,30,54
"Kuwait","Middle East","c",2019,13,23,36
"Kyrgyzstan","Eurasia","c",2019,12,26,38
"Laos","Asia","c",2019,2,12,14
"Latvia","Europe","c",2019,35,52,87
"Lebanon","Middle East","c",2019,14,31,45
"Lesotho","Africa","c",2019,27,36,63
"Liberia","Africa","c",2019,27,35,62
"Libya","Africa","c",2019,1,8,9
"Liechtenstein","Europe","c",2019,33,57,90
"Lithuania","Europe","c",2019,38,53,91
"Luxembourg","Europe","c",2019,38,60,98
"Madagascar","Africa","c",2019,24,32,56
"Malawi","Africa","c",2019,26,38,64
"Malaysia","Asia","c",2019,21,31,52
"Maldives","Asia","c",2019,14,21,35
"Mali","Africa","c",2019,18,26,44
"Malta","Europe","c",2019,35,56,91
"Marshall Islands","Asia","c",2019,38,55,93
"Mauritania","Africa","c",2019,11,21,32
"Mauritius","Africa","c",2019,37,52,89
"Mexico","Americas","c",2019,27,36,63
"Micronesia","Asia","c",2019,37,55,92
"Moldova","Eurasia","c",2019,24,34,58
"Monaco","Europe","c",2019,26,56,82
"Mongolia","Asia","c",2019,36,49,85
"Montenegro","Europe","c",2019,23,42,65
"Morocco","Africa","c",2019,14,25,39
"Mozambique","Africa","c",2019,19,32,51
"Myanmar","Asia","c",2019,13,17,30
"Nagorno-Karabakh","Eurasia","t",2019,12,19,31
"Namibia","Africa","c",2019,29,46,75
"Nauru","Asia","c",2019,34,44,78
"Nepal","Asia","c",2019,25,29,54
"Netherlands","Europe","c",2019,40,59,99
"New Zealand","Asia","c",2019,40,58,98
"Nicaragua","Americas","c",2019,10,22,32
"Niger","Africa","c",2019,20,29,49
"Nigeria","Africa","c",2019,25,25,50
"North Korea","Asia","c",2019,0,3,3
"North Macedonia","Europe","c",2019,22,37,59
"Northern Cyprus","Europe","t",2019,31,50,81
"Norway","Europe","c",2019,40,60,100
"Oman","Middle East","c",2019,6,17,23
"Pakistan","Asia","c",2019,17,22,39
"Pakistani Kashmir","Asia","t",2019,9,19,28
"Palau","Asia","c",2019,37,55,92
"Panama","Americas","c",2019,36,48,84
"Papua New Guinea","Asia","c",2019,23,41,64
"Paraguay","Americas","c",2019,28,37,65
"Peru","Americas","c",2019,31,42,73
"Philippines","Asia","c",2019,26,35,61
"Poland","Europe","c",2019,35,49,84
"Portugal","Europe","c",2019,39,57,96
"Qatar","Middle East","c",2019,7,18,25
"Romania","Europe","c",2019,34,47,81
"Russia","Eurasia","c",2019,5,15,20
"Rwanda","Africa","c",2019,9,14,23
"Samoa","Asia","c",2019,30,51,81
"San Marino","Europe","c",2019,38,57,95
"Sao Tome and Principe","Africa","c",2019,34,49,83
"Saudi Arabia","Middle East","c",2019,1,6,7
"Senegal","Africa","c",2019,30,42,72
"Serbia","Europe","c",2019,24,43,67
"Seychelles","Africa","c",2019,28,43,71
"Sierra Leone","Africa","c",2019,28,37,65
"Singapore","Asia","c",2019,19,32,51
"Slovakia","Europe","c",2019,36,52,88
"Slovenia","Europe","c",2019,39,55,94
"Solomon Islands","Asia","c",2019,30,49,79
"Somalia","Africa","c",2019,1,6,7
"Somaliland","Africa","t",2019,19,24,43
"South Africa","Africa","c",2019,33,46,79
"South Korea","Asia","c",2019,33,50,83
"South Ossetia","Eurasia","t",2019,2,8,10
"South Sudan","Africa","c",2019,-2,4,2
"Spain","Europe","c",2019,39,55,94
"Sri Lanka","Asia","c",2019,24,32,56
"St. Kitts and Nevis","Americas","c",2019,36,53,89
"St. Lucia","Americas","c",2019,38,54,92
"St. Vincent and the Grenadines","Americas","c",2019,36,55,91
"Sudan","Africa","c",2019,3,4,7
"Suriname","Americas","c",2019,34,43,77
"Sweden","Europe","c",2019,40,60,100
"Switzerland","Europe","c",2019,39,57,96
"Syria","Middle East","c",2019,-3,3,0
"Taiwan","Asia","c",2019,37,56,93
"Tajikistan","Eurasia","c",2019,0,9,9
"Tanzania","Africa","c",2019,20,25,45
"Thailand","Asia","c",2019,5,25,30
"The Gambia","Africa","c",2019,20,25,45
"Tibet","Asia","t",2019,-2,3,1
"Timor-Leste","Asia","c",2019,32,38,70
"Togo","Africa","c",2019,15,28,43
"Tonga","Asia","c",2019,30,49,79
"Transnistria","Eurasia","t",2019,10,14,24
"Trinidad and Tobago","Americas","c",2019,33,49,82
"Tunisia","Africa","c",2019,31,38,69
"Turkey","Europe","c",2019,15,16,31
"Turkmenistan","Eurasia","c",2019,0,2,2
"Tuvalu","Asia","c",2019,37,56,93
"Uganda","Africa","c",2019,11,25,36
"Ukraine","Eurasia","c",2019,26,34,60
"United Arab Emirates","Middle East","c",2019,5,12,17
"United Kingdom","Europe","c",2019,39,54,93
"United States","Americas","c",2019,33,53,86
"Uruguay","Americas","c",2019,40,58,98
"Uzbekistan","Eurasia","c",2019,1,8,9
"Vanuatu","Asia","c",2019,33,49,82
"Venezuela","Americas","c",2019,3,16,19
"Vietnam","Asia","c",2019,3,17,20
"West Bank","Middle East","t",2019,4,21,25
"Western Sahara","Africa","t",2019,-3,7,4
"Yemen","Middle East","c",2019,1,10,11
"Zambia","Africa","c",2019,22,32,54
"Zimbabwe","Africa","c",2019,12,19,31
"Abkhazia","Eurasia","t",2018,18,23,41
"Afghanistan","Asia","c",2018,12,14,26
"Albania","Europe","c",2018,28,40,68
"Algeria","Africa","c",2018,10,25,35
"Andorra","Europe","c",2018,39,57,96
"Angola","Africa","c",2018,10,16,26
"Antigua and Barbuda","Americas","c",2018,33,50,83
"Argentina","Americas","c",2018,33,50,83
"Armenia","Eurasia","c",2018,15,30,45
"Australia","Asia","c",2018,40,58,98
"Austria","Europe","c",2018,37,57,94
"Azerbaijan","Eurasia","c",2018,3,9,12
"Bahamas","Americas","c",2018,38,53,91
"Bahrain","Middle East","c",2018,2,10,12
"Bangladesh","Asia","c",2018,19,26,45
"Barbados","Americas","c",2018,38,58,96
"Belarus","Eurasia","c",2018,6,15,21
"Belgium","Europe","c",2018,39,56,95
"Belize","Americas","c",2018,36,50,86
"Benin","Africa","c",2018,33,49,82
"Bhutan","Asia","c",2018,28,27,55
"Bolivia","Americas","c",2018,28,39,67
"Bosnia and Herzegovina","Europe","c",2018,21,34,55
"Botswana","Africa","c",2018,28,44,72
"Brazil","Americas","c",2018,31,47,78
"Brunei","Asia","c",2018,6,22,28
"Bulgaria","Europe","c",2018,33,47,80
"Burkina Faso","Africa","c",2018,23,37,60
"Burundi","Africa","c",2018,4,14,18
"Cabo Verde","Africa","c",2018,37,53,90
"Cambodia","Asia","c",2018,10,20,30
"Cameroon","Africa","c",2018,9,13,22
"Canada","Americas","c",2018,40,59,99
"Central African Republic","Africa","c",2018,4,5,9
"Chad","Africa","c",2018,4,14,18
"Chile","Americas","c",2018,37,57,94
"China","Asia","c",2018,0,14,14
"Colombia","Americas","c",2018,29,36,65
"Comoros","Africa","c",2018,24,31,55
"Congo (Brazzaville)","Africa","c",2018,2,19,21
"Congo (Kinshasa)","Africa","c",2018,4,13,17
"Costa Rica","Americas","c",2018,38,53,91
"Cote d'Ivoire","Africa","c",2018,19,32,51
"Crimea","Eurasia","t",2018,-1,10,9
"Croatia","Europe","c",2018,37,49,86
"Cuba","Americas","c",2018,1,13,14
"Cyprus","Europe","c",2018,38,56,94
"Czech Republic","Europe","c",2018,37,56,93
"Denmark","Europe","c",2018,40,57,97
"Djibouti","Africa","c",2018,7,19,26
"Dominica","Americas","c",2018,37,56,93
"Dominican Republic","Americas","c",2018,26,41,67
"Ecuador","Americas","c",2018,25,35,60
"Egypt","Africa","c",2018,10,16,26
"El Salvador","Americas","c",2018,34,36,70
"Equatorial Guinea","Africa","c",2018,1,6,7
"Eritrea","Africa","c",2018,1,2,3
"Estonia","Europe","c",2018,38,56,94
"Eswatini","Africa","c",2018,1,15,16
"Ethiopia","Africa","c",2018,4,8,12
"Fiji","Asia","c",2018,24,35,59
"Finland","Europe","c",2018,40,60,100
"France","Europe","c",2018,38,52,90
"Gabon","Africa","c",2018,4,19,23
"Gaza Strip","Middle East","t",2018,3,9,12
"Georgia","Eurasia","c",2018,26,38,64
"Germany","Europe","c",2018,39,55,94
"Ghana","Africa","c",2018,37,46,83
"Greece","Europe","c",2018,35,50,85
"Grenada","Americas","c",2018,37,51,88
"Guatemala","Americas","c",2018,23,33,56
"Guinea","Africa","c",2018,17,24,41
"Guinea-Bissau","Africa","c",2018,16,25,41
"Guyana","Americas","c",2018,32,42,74
"Haiti","Americas","c",2018,17,24,41
"Honduras","Americas","c",2018,20,26,46
"Hong Kong","Asia","t",2018,15,44,59
"Hungary","Europe","c",2018,28,44,72
"Iceland","Europe","c",2018,37,58,95
"India","Asia","c",2018,35,42,77
"Indian Kashmir","Asia","t",2018,22,27,49
"Indonesia","Asia","c",2018,30,34,64
"Iran","Middle East","c",2018,7,11,18
"Iraq","Middle East","c",2018,16,15,31
"Ireland","Europe","c",2018,39,57,96
"Israel","Middle East","c",2018,36,43,79
"Italy","Europe","c",2018,36,53,89
"Jamaica","Americas","c",2018,34,43,77
"Japan","Asia","c",2018,40,56,96
"Jordan","Middle East","c",2018,12,25,37
"Kazakhstan","Eurasia","c",2018,5,17,22
"Kenya","Africa","c",2018,19,29,48
"Kiribati","Asia","c",2018,38,55,93
"Kosovo","Europe","c",2018,24,28,52
"Kuwait","Middle East","c",2018,13,23,36
"Kyrgyzstan","Eurasia","c",2018,12,25,37
"Laos","Asia","c",2018,1,11,12
"Latvia","Europe","c",2018,35,52,87
"Lebanon","Middle East","c",2018,11,32,43
"Lesotho","Africa","c",2018,27,37,64
"Liberia","Africa","c",2018,27,35,62
"Libya","Africa","c",2018,1,8,9
"Liechtenstein","Europe","c",2018,33,57,90
"Lithuania","Europe","c",2018,38,53,91
"Luxembourg","Europe","c",2018,38,60,98
"Madagascar","Africa","c",2018,24,32,56
"Malawi","Africa","c",2018,26,37,63
"Malaysia","Asia","c",2018,18,27,45
"Maldives","Asia","c",2018,14,21,35
"Mali","Africa","c",2018,17,27,44
"Malta","Europe","c",2018,36,56,92
"Marshall Islands","Asia","c",2018,37,55,92
"Mauritania","Africa","c",2018,9,21,30
"Mauritius","Africa","c",2018,37,52,89
"Mexico","Americas","c",2018,26,36,62
"Micronesia","Asia","c",2018,37,56,93
"Moldova","Eurasia","c",2018,26,35,61
"Monaco","Europe","c",2018,25,57,82
"Mongolia","Asia","c",2018,36,49,85
"Montenegro","Europe","c",2018,25,42,67
"Morocco","Africa","c",2018,14,25,39
"Mozambique","Africa","c",2018,20,32,52
"Myanmar","Asia","c",2018,13,18,31
"Nagorno-Karabakh","Eurasia","t",2018,12,18,30
"Namibia","Africa","c",2018,30,47,77
"Nauru","Asia","c",2018,35,46,81
"Nepal","Asia","c",2018,25,30,55
"Netherlands","Europe","c",2018,40,59,99
"New Zealand","Asia","c",2018,40,58,98
"Nicaragua","Americas","c",2018,12,32,44
"Niger","Africa","c",2018,20,29,49
"Nigeria","Africa","c",2018,25,25,50
"North Korea","Asia","c",2018,0,3,3
"North Macedonia","Europe","c",2018,21,37,58
"Northern Cyprus","Europe","t",2018,31,50,81
"Norway","Europe","c",2018,40,60,100
"Oman","Middle East","c",2018,6,17,23
"Pakistan","Asia","c",2018,19,24,43
"Pakistani Kashmir","Asia","t",2018,9,19,28
"Palau","Asia","c",2018,37,55,92
"Panama","Americas","c",2018,35,48,83
"Papua New Guinea","Asia","c",2018,25,38,63
"Paraguay","Americas","c",2018,27,37,64
"Peru","Americas","c",2018,31,42,73
"Philippines","Asia","c",2018,27,35,62
"Poland","Europe","c",2018,36,49,85
"Portugal","Europe","c",2018,39,58,97
"Qatar","Middle East","c",2018,7,17,24
"Romania","Europe","c",2018,35,49,84
"Russia","Eurasia","c",2018,5,15,20
"Rwanda","Africa","c",2018,8,15,23
"Samoa","Asia","c",2018,30,50,80
"San Marino","Europe","c",2018,38,59,97
"Sao Tome and Principe","Africa","c",2018,34,48,82
"Saudi Arabia","Middle East","c",2018,0,7,7
"Senegal","Africa","c",2018,31,44,75
"Serbia","Europe","c",2018,28,45,73
"Seychelles","Africa","c",2018,28,43,71
"Sierra Leone","Africa","c",2018,28,38,66
"Singapore","Asia","c",2018,19,33,52
"Slovakia","Europe","c",2018,36,53,89
"Slovenia","Europe","c",2018,39,54,93
"Solomon Islands","Asia","c",2018,28,44,72
"Somalia","Africa","c",2018,1,6,7
"Somaliland","Africa","t",2018,19,25,44
"South Africa","Africa","c",2018,32,46,78
"South Korea","Asia","c",2018,33,51,84
"South Ossetia","Eurasia","t",2018,2,8,10
"South Sudan","Africa","c",2018,-2,4,2
"Spain","Europe","c",2018,38,56,94
"Sri Lanka","Asia","c",2018,24,31,55
"St. Kitts and Nevis","Americas","c",2018,36,53,89
"St. Lucia","Americas","c",2018,38,53,91
"St. Vincent and the Grenadines","Americas","c",2018,36,54,90
"Sudan","Africa","c",2018,4,4,8
"Suriname","Americas","c",2018,34,44,78
"Sweden","Europe","c",2018,40,60,100
"Switzerland","Europe","c",2018,39,57,96
"Syria","Middle East","c",2018,-3,2,-1
"Taiwan","Asia","c",2018,37,56,93
"Tajikistan","Eurasia","c",2018,1,10,11
"Tanzania","Africa","c",2018,22,30,52
"Thailand","Asia","c",2018,6,25,31
"The Gambia","Africa","c",2018,20,21,41
"Tibet","Asia","t",2018,-2,3,1
"Timor-Leste","Asia","c",2018,32,37,69
"Togo","Africa","c",2018,18,29,47
"Tonga","Asia","c",2018,30,45,75
"Transnistria","Eurasia","t",2018,10,14,24
"Trinidad and Tobago","Americas","c",2018,33,48,81
"Tunisia","Africa","c",2018,30,40,70
"Turkey","Europe","c",2018,16,16,32
"Turkmenistan","Eurasia","c",2018,0,4,4
"Tuvalu","Asia","c",2018,37,57,94
"Uganda","Africa","c",2018,11,26,37
"Ukraine","Eurasia","c",2018,26,36,62
"United Arab Emirates","Middle East","c",2018,5,12,17
"United Kingdom","Europe","c",2018,40,54,94
"United States","Americas","c",2018,33,53,86
"Uruguay","Americas","c",2018,40,58,98
"Uzbekistan","Eurasia","c",2018,1,6,7
"Vanuatu","Asia","c",2018,33,48,81
"Venezuela","Americas","c",2018,8,18,26
"Vietnam","Asia","c",2018,3,17,20
"West Bank","Middle East","t",2018,5,23,28
"Western Sahara","Africa","t",2018,-3,7,4
"Yemen","Middle East","c",2018,1,12,13
"Zambia","Africa","c",2018,22,33,55
"Zimbabwe","Africa","c",2018,10,20,30
"Abkhazia","Eurasia","t",2017,18,23,41
"Afghanistan","Asia","c",2017,10,14,24
"Albania","Europe","c",2017,28,40,68
"Algeria","Africa","c",2017,11,24,35
"Andorra","Europe","c",2017,39,56,95
"Angola","Africa","c",2017,10,14,24
"Antigua and Barbuda","Americas","c",2017,33,50,83
"Argentina","Americas","c",2017,33,49,82
"Armenia","Eurasia","c",2017,16,29,45
"Australia","Asia","c",2017,40,58,98
"Austria","Europe","c",2017,37,58,95
"Azerbaijan","Eurasia","c",2017,4,10,14
"Bahamas","Americas","c",2017,38,53,91
"Bahrain","Middle East","c",2017,2,10,12
"Bangladesh","Asia","c",2017,20,27,47
"Barbados","Americas","c",2017,40,58,98
"Belarus","Eurasia","c",2017,5,15,20
"Belgium","Europe","c",2017,40,55,95
"Belize","Americas","c",2017,36,51,87
"Benin","Africa","c",2017,33,49,82
"Bhutan","Asia","c",2017,28,27,55
"Bolivia","Americas","c",2017,29,39,68
"Bosnia and Herzegovina","Europe","c",2017,21,34,55
"Botswana","Africa","c",2017,28,44,72
"Brazil","Americas","c",2017,31,48,79
"Brunei","Asia","c",2017,7,22,29
"Bulgaria","Europe","c",2017,33,47,80
"Burkina Faso","Africa","c",2017,23,40,63
"Burundi","Africa","c",2017,5,14,19
"Cabo Verde","Africa","c",2017,37,53,90
"Cambodia","Asia","c",2017,11,20,31
"Cameroon","Africa","c",2017,9,15,24
"Canada","Americas","c",2017,40,59,99
"Central African Republic","Africa","c",2017,4,6,10
"Chad","Africa","c",2017,4,14,18
"Chile","Americas","c",2017,37,57,94
"China","Asia","c",2017,1,14,15
"Colombia","Americas","c",2017,29,35,64
"Comoros","Africa","c",2017,24,31,55
"Congo (Brazzaville)","Africa","c",2017,5,22,27
"Congo (Kinshasa)","Africa","c",2017,4,15,19
"Costa Rica","Americas","c",2017,38,53,91
"Cote d'Ivoire","Africa","c",2017,20,32,52
"Crimea","Eurasia","t",2017,-1,10,9
"Croatia","Europe","c",2017,37,50,87
"Cuba","Americas","c",2017,1,14,15
"Cyprus","Europe","c",2017,38,56,94
"Czech Republic","Europe","c",2017,38,56,94
"Denmark","Europe","c",2017,40,57,97
"Djibouti","Africa","c",2017,7,19,26
"Dominica","Americas","c",2017,38,57,95
"Dominican Republic","Americas","c",2017,27,41,68
"Ecuador","Americas","c",2017,24,33,57
"Egypt","Africa","c",2017,9,17,26
"El Salvador","Americas","c",2017,34,36,70
"Equatorial Guinea","Africa","c",2017,1,7,8
"Eritrea","Africa","c",2017,1,2,3
"Estonia","Europe","c",2017,38,56,94
"Eswatini","Africa","c",2017,1,17,18
"Ethiopia","Africa","c",2017,4,8,12
"Fiji","Asia","c",2017,25,34,59
"Finland","Europe","c",2017,40,60,100
"France","Europe","c",2017,38,52,90
"Gabon","Africa","c",2017,8,24,32
"Gaza Strip","Middle East","t",2017,3,9,12
"Georgia","Eurasia","c",2017,27,37,64
"Germany","Europe","c",2017,39,56,95
"Ghana","Africa","c",2017,37,46,83
"Greece","Europe","c",2017,35,49,84
"Grenada","Americas","c",2017,38,51,89
"Guatemala","Americas","c",2017,23,31,54
"Guinea","Africa","c",2017,17,24,41
"Guinea-Bissau","Africa","c",2017,16,24,40
"Guyana","Americas","c",2017,32,42,74
"Haiti","Americas","c",2017,15,24,39
"Honduras","Americas","c",2017,19,27,46
"Hong Kong","Asia","t",2017,16,45,61
"Hungary","Europe","c",2017,29,47,76
"Iceland","Europe","c",2017,38,59,97
"India","Asia","c",2017,35,42,77
"Indian Kashmir","Asia","t",2017,22,28,50
"Indonesia","Asia","c",2017,31,34,65
"Iran","Middle East","c",2017,7,10,17
"Iraq","Middle East","c",2017,12,15,27
"Ireland","Europe","c",2017,39,57,96
"Israel","Middle East","c",2017,36,44,80
"Italy","Europe","c",2017,36,53,89
"Jamaica","Americas","c",2017,34,41,75
"Japan","Asia","c",2017,40,56,96
"Jordan","Middle East","c",2017,12,25,37
"Kazakhstan","Eurasia","c",2017,5,17,22
"Kenya","Africa","c",2017,22,29,51
"Kiribati","Asia","c",2017,37,55,92
"Kosovo","Europe","c",2017,24,28,52
"Kuwait","Middle East","c",2017,13,23,36
"Kyrgyzstan","Eurasia","c",2017,13,24,37
"Laos","Asia","c",2017,1,11,12
"Latvia","Europe","c",2017,36,51,87
"Lebanon","Middle East","c",2017,14,30,44
"Lesotho","Africa","c",2017,27,37,64
"Liberia","Africa","c",2017,28,34,62
"Libya","Africa","c",2017,3,10,13
"Liechtenstein","Europe","c",2017,33,58,91
"Lithuania","Europe","c",2017,38,53,91
"Luxembourg","Europe","c",2017,38,60,98
"Madagascar","Africa","c",2017,24,32,56
"Malawi","Africa","c",2017,26,37,63
"Malaysia","Asia","c",2017,18,26,44
"Maldives","Asia","c",2017,17,23,40
"Mali","Africa","c",2017,17,28,45
"Malta","Europe","c",2017,39,57,96
"Marshall Islands","Asia","c",2017,37,55,92
"Mauritania","Africa","c",2017,9,21,30
"Mauritius","Africa","c",2017,37,52,89
"Mexico","Americas","c",2017,28,37,65
"Micronesia","Asia","c",2017,37,56,93
"Moldova","Eurasia","c",2017,27,35,62
"Monaco","Europe","c",2017,27,57,84
"Mongolia","Asia","c",2017,36,49,85
"Montenegro","Europe","c",2017,26,43,69
"Morocco","Africa","c",2017,15,26,41
"Mozambique","Africa","c",2017,20,33,53
"Myanmar","Asia","c",2017,14,18,32
"Nagorno-Karabakh","Eurasia","t",2017,15,18,33
"Namibia","Africa","c",2017,30,47,77
"Nauru","Asia","c",2017,35,46,81
"Nepal","Asia","c",2017,24,28,52
"Netherlands","Europe","c",2017,40,59,99
"New Zealand","Asia","c",2017,40,58,98
"Nicaragua","Americas","c",2017,14,33,47
"Niger","Africa","c",2017,21,28,49
"Nigeria","Africa","c",2017,25,25,50
"North Korea","Asia","c",2017,0,3,3
"North Macedonia","Europe","c",2017,21,36,57
"Northern Cyprus","Europe","t",2017,32,48,80
"Norway","Europe","c",2017,40,60,100
"Oman","Middle East","c",2017,8,17,25
"Pakistan","Asia","c",2017,21,22,43
"Pakistani Kashmir","Asia","t",2017,9,19,28
"Palau","Asia","c",2017,37,55,92
"Panama","Americas","c",2017,35,48,83
"Papua New Guinea","Asia","c",2017,26,38,64
"Paraguay","Americas","c",2017,27,37,64
"Peru","Americas","c",2017,31,41,72
"Philippines","Asia","c",2017,27,36,63
"Poland","Europe","c",2017,37,52,89
"Portugal","Europe","c",2017,39,58,97
"Qatar","Middle East","c",2017,9,17,26
"Romania","Europe","c",2017,35,49,84
"Russia","Eurasia","c",2017,5,15,20
"Rwanda","Africa","c",2017,8,16,24
"Samoa","Asia","c",2017,30,50,80
"San Marino","Europe","c",2017,38,59,97
"Sao Tome and Principe","Africa","c",2017,34,47,81
"Saudi Arabia","Middle East","c",2017,3,7,10
"Senegal","Africa","c",2017,32,46,78
"Serbia","Europe","c",2017,29,47,76
"Seychelles","Africa","c",2017,28,43,71
"Sierra Leone","Africa","c",2017,28,38,66
"Singapore","Asia","c",2017,19,32,51
"Slovakia","Europe","c",2017,36,53,89
"Slovenia","Europe","c",2017,39,53,92
"Solomon Islands","Asia","c",2017,27,44,71
"Somalia","Africa","c",2017,0,5,5
"Somaliland","Africa","t",2017,15,25,40
"South Africa","Africa","c",2017,33,45,78
"South Korea","Asia","c",2017,32,50,82
"South Ossetia","Eurasia","t",2017,2,9,11
"South Sudan","Africa","c",2017,-2,6,4
"Spain","Europe","c",2017,38,56,94
"Sri Lanka","Asia","c",2017,24,32,56
"St. Kitts and Nevis","Americas","c",2017,36,53,89
"St. Lucia","Americas","c",2017,39,53,92
"St. Vincent and the Grenadines","Americas","c",2017,37,54,91
"Sudan","Africa","c",2017,2,4,6
"Suriname","Americas","c",2017,34,43,77
"Sweden","Europe","c",2017,40,60,100
"Switzerland","Europe","c",2017,39,57,96
"Syria","Middle East","c",2017,-3,2,-1
"Taiwan","Asia","c",2017,37,54,91
"Tajikistan","Eurasia","c",2017,1,10,11
"Tanzania","Africa","c",2017,25,33,58
"Thailand","Asia","c",2017,7,25,32
"The Gambia","Africa","c",2017,8,12,20
"Tibet","Asia","t",2017,-2,3,1
"Timor-Leste","Asia","c",2017,29,36,65
"Togo","Africa","c",2017,18,30,48
"Tonga","Asia","c",2017,30,44,74
"Transnistria","Eurasia","t",2017,10,14,24
"Trinidad and Tobago","Americas","c",2017,33,48,81
"Tunisia","Africa","c",2017,36,42,78
"Turkey","Europe","c",2017,18,20,38
"Turkmenistan","Eurasia","c",2017,0,4,4
"Tuvalu","Asia","c",2017,37,57,94
"Uganda","Africa","c",2017,11,24,35
"Ukraine","Eurasia","c",2017,25,36,61
"United Arab Emirates","Middle East","c",2017,7,13,20
"United Kingdom","Europe","c",2017,40,55,95
"United States","Americas","c",2017,36,53,89
"Uruguay","Americas","c",2017,40,58,98
"Uzbekistan","Eurasia","c",2017,0,3,3
"Vanuatu","Asia","c",2017,32,48,80
"Venezuela","Americas","c",2017,11,19,30
"Vietnam","Asia","c",2017,3,17,20
"West Bank","Middle East","t",2017,5,23,28
"Western Sahara","Africa","t",2017,-3,7,4
"Yemen","Middle East","c",2017,2,12,14
"Zambia","Africa","c",2017,23,33,56
"Zimbabwe","Africa","c",2017,12,20,32
"Abkhazia","Eurasia","t",2016,19,23,42
"Afghanistan","Asia","c",2016,10,14,24
"Albania","Europe","c",2016,27,40,67
"Algeria","Africa","c",2016,11,24,35
"Andorra","Europe","c",2016,39,57,96
"Angola","Africa","c",2016,10,14,24
"Antigua and Barbuda","Americas","c",2016,33,49,82
"Argentina","Americas","c",2016,31,48,79
"Armenia","Eurasia","c",2016,16,30,46
"Australia","Asia","c",2016,40,58,98
"Austria","Europe","c",2016,37,58,95
"Azerbaijan","Eurasia","c",2016,5,11,16
"Bahamas","Americas","c",2016,38,54,92
"Bahrain","Middle East","c",2016,4,10,14
"Bangladesh","Asia","c",2016,21,28,49
"Barbados","Americas","c",2016,40,58,98
"Belarus","Eurasia","c",2016,4,13,17
"Belgium","Europe","c",2016,40,56,96
"Belize","Americas","c",2016,36,51,87
"Benin","Africa","c",2016,33,49,82
"Bhutan","Asia","c",2016,29,27,56
"Bolivia","Americas","c",2016,29,39,68
"Bosnia and Herzegovina","Europe","c",2016,22,35,57
"Botswana","Africa","c",2016,28,45,73
"Brazil","Americas","c",2016,33,48,81
"Brunei","Asia","c",2016,7,22,29
"Bulgaria","Europe","c",2016,33,47,80
"Burkina Faso","Africa","c",2016,21,38,59
"Burundi","Africa","c",2016,5,14,19
"Cabo Verde","Africa","c",2016,37,53,90
"Cambodia","Asia","c",2016,11,21,32
"Cameroon","Africa","c",2016,9,15,24
"Canada","Americas","c",2016,40,59,99
"Central African Republic","Africa","c",2016,1,6,7
"Chad","Africa","c",2016,4,16,20
"Chile","Americas","c",2016,38,57,95
"China","Asia","c",2016,1,15,16
"Colombia","Americas","c",2016,29,34,63
"Comoros","Africa","c",2016,24,31,55
"Congo (Brazzaville)","Africa","c",2016,6,22,28
"Congo (Kinshasa)","Africa","c",2016,9,16,25
"Costa Rica","Americas","c",2016,37,53,90
"Cote d'Ivoire","Africa","c",2016,20,31,51
"Crimea","Eurasia","t",2016,-1,10,9
"Croatia","Europe","c",2016,37,50,87
"Cuba","Americas","c",2016,1,14,15
"Cyprus","Europe","c",2016,38,56,94
"Czech Republic","Europe","c",2016,38,57,95
"Denmark","Europe","c",2016,40,58,98
"Djibouti","Africa","c",2016,9,19,28
"Dominica","Americas","c",2016,38,57,95
"Dominican Republic","Americas","c",2016,29,41,70
"Ecuador","Americas","c",2016,24,35,59
"Egypt","Africa","c",2016,9,18,27
"El Salvador","Americas","c",2016,33,36,69
"Equatorial Guinea","Africa","c",2016,1,7,8
"Eritrea","Africa","c",2016,1,2,3
"Estonia","Europe","c",2016,38,56,94
"Eswatini","Africa","c",2016,1,17,18
"Ethiopia","Africa","c",2016,4,11,15
"Fiji","Asia","c",2016,27,35,62
"Finland","Europe","c",2016,40,60,100
"France","Europe","c",2016,38,53,91
"Gabon","Africa","c",2016,9,25,34
"Gaza Strip","Middle East","t",2016,3,9,12
"Georgia","Eurasia","c",2016,27,37,64
"Germany","Europe","c",2016,39,56,95
"Ghana","Africa","c",2016,37,46,83
"Greece","Europe","c",2016,35,48,83
"Grenada","Americas","c",2016,38,51,89
"Guatemala","Americas","c",2016,23,31,54
"Guinea","Africa","c",2016,17,23,40
"Guinea-Bissau","Africa","c",2016,16,23,39
"Guyana","Americas","c",2016,32,42,74
"Haiti","Americas","c",2016,17,24,41
"Honduras","Americas","c",2016,19,26,45
"Hong Kong","Asia","t",2016,16,47,63
"Hungary","Europe","c",2016,32,47,79
"Iceland","Europe","c",2016,40,60,100
"India","Asia","c",2016,35,42,77
"Indian Kashmir","Asia","t",2016,22,29,51
"Indonesia","Asia","c",2016,31,34,65
"Iran","Middle East","c",2016,7,10,17
"Iraq","Middle East","c",2016,12,15,27
"Ireland","Europe","c",2016,39,57,96
"Israel","Middle East","c",2016,36,44,80
"Italy","Europe","c",2016,36,53,89
"Jamaica","Americas","c",2016,34,41,75
"Japan","Asia","c",2016,40,56,96
"Jordan","Middle East","c",2016,11,25,36
"Kazakhstan","Eurasia","c",2016,6,18,24
"Kenya","Africa","c",2016,22,29,51
"Kiribati","Asia","c",2016,36,55,91
"Kosovo","Europe","c",2016,24,28,52
"Kuwait","Middle East","c",2016,13,23,36
"Kyrgyzstan","Eurasia","c",2016,14,24,38
"Laos","Asia","c",2016,1,11,12
"Latvia","Europe","c",2016,35,51,86
"Lebanon","Middle East","c",2016,13,30,43
"Lesotho","Africa","c",2016,28,39,67
"Liberia","Africa","c",2016,28,33,61
"Libya","Africa","c",2016,6,14,20
"Liechtenstein","Europe","c",2016,39,59,98
"Lithuania","Europe","c",2016,38,53,91
"Luxembourg","Europe","c",2016,38,60,98
"Madagascar","Africa","c",2016,24,32,56
"Malawi","Africa","c",2016,27,37,64
"Malaysia","Asia","c",2016,18,27,45
"Maldives","Asia","c",2016,19,24,43
"Mali","Africa","c",2016,17,28,45
"Malta","Europe","c",2016,39,57,96
"Marshall Islands","Asia","c",2016,37,55,92
"Mauritania","Africa","c",2016,9,21,30
"Mauritius","Africa","c",2016,38,52,90
"Mexico","Americas","c",2016,28,37,65
"Micronesia","Asia","c",2016,37,56,93
"Moldova","Eurasia","c",2016,25,35,60
"Monaco","Europe","c",2016,31,57,88
"Mongolia","Asia","c",2016,36,50,86
"Montenegro","Europe","c",2016,27,43,70
"Morocco","Africa","c",2016,15,26,41
"Mozambique","Africa","c",2016,22,34,56
"Myanmar","Asia","c",2016,11,17,28
"Nagorno-Karabakh","Eurasia","t",2016,15,18,33
"Namibia","Africa","c",2016,30,47,77
"Nauru","Asia","c",2016,35,49,84
"Nepal","Asia","c",2016,25,26,51
"Netherlands","Europe","c",2016,40,59,99
"New Zealand","Asia","c",2016,40,58,98
"Nicaragua","Americas","c",2016,19,35,54
"Niger","Africa","c",2016,24,28,52
"Nigeria","Africa","c",2016,23,25,48
"North Korea","Asia","c",2016,0,3,3
"North Macedonia","Europe","c",2016,22,35,57
"Northern Cyprus","Europe","t",2016,32,47,79
"Norway","Europe","c",2016,40,60,100
"Oman","Middle East","c",2016,8,17,25
"Pakistan","Asia","c",2016,20,21,41
"Pakistani Kashmir","Asia","t",2016,9,19,28
"Palau","Asia","c",2016,37,55,92
"Panama","Americas","c",2016,35,48,83
"Papua New Guinea","Asia","c",2016,23,36,59
"Paraguay","Americas","c",2016,27,37,64
"Peru","Americas","c",2016,30,41,71
"Philippines","Asia","c",2016,27,38,65
"Poland","Europe","c",2016,38,55,93
"Portugal","Europe","c",2016,39,58,97
"Puerto Rico","Americas","t",2016,37,53,90
"Qatar","Middle East","c",2016,9,18,27
"Romania","Europe","c",2016,34,49,83
"Russia","Eurasia","c",2016,7,15,22
"Rwanda","Africa","c",2016,8,16,24
"Samoa","Asia","c",2016,31,49,80
"San Marino","Europe","c",2016,40,60,100
"Sao Tome and Principe","Africa","c",2016,34,47,81
"Saudi Arabia","Middle East","c",2016,3,7,10
"Senegal","Africa","c",2016,33,45,78
"Serbia","Europe","c",2016,30,48,78
"Seychelles","Africa","c",2016,26,42,68
"Sierra Leone","Africa","c",2016,28,37,65
"Singapore","Asia","c",2016,19,32,51
"Slovakia","Europe","c",2016,36,53,89
"Slovenia","Europe","c",2016,39,53,92
"Solomon Islands","Asia","c",2016,25,43,68
"Somalia","Africa","c",2016,0,2,2
"Somaliland","Africa","t",2016,15,25,40
"South Africa","Africa","c",2016,33,46,79
"South Korea","Asia","c",2016,34,49,83
"South Ossetia","Eurasia","t",2016,2,9,11
"South Sudan","Africa","c",2016,2,12,14
"Spain","Europe","c",2016,39,56,95
"Sri Lanka","Asia","c",2016,23,32,55
"St. Kitts and Nevis","Americas","c",2016,35,53,88
"St. Lucia","Americas","c",2016,39,53,92
"St. Vincent and the Grenadines","Americas","c",2016,37,54,91
"Sudan","Africa","c",2016,2,4,6
"Suriname","Americas","c",2016,34,43,77
"Sweden","Europe","c",2016,40,60,100
"Switzerland","Europe","c",2016,39,57,96
"Syria","Middle East","c",2016,-3,2,-1
"Taiwan","Asia","c",2016,37,52,89
"Tajikistan","Eurasia","c",2016,2,14,16
"Tanzania","Africa","c",2016,27,33,60
"Thailand","Asia","c",2016,7,25,32
"The Gambia","Africa","c",2016,5,13,18
"Tibet","Asia","t",2016,-2,3,1
"Timor-Leste","Asia","c",2016,29,36,65
"Togo","Africa","c",2016,18,30,48
"Tonga","Asia","c",2016,31,44,75
"Transnistria","Eurasia","t",2016,10,14,24
"Trinidad and Tobago","Americas","c",2016,33,48,81
"Tunisia","Africa","c",2016,37,42,79
"Turkey","Europe","c",2016,24,29,53
"Turkmenistan","Eurasia","c",2016,0,4,4
"Tuvalu","Asia","c",2016,37,57,94
"Uganda","Africa","c",2016,11,25,36
"Ukraine","Eurasia","c",2016,25,36,61
"United Arab Emirates","Middle East","c",2016,7,13,20
"United Kingdom","Europe","c",2016,40,55,95
"United States","Americas","c",2016,36,54,90
"Uruguay","Americas","c",2016,40,58,98
"Uzbekistan","Eurasia","c",2016,0,3,3
"Vanuatu","Asia","c",2016,31,47,78
"Venezuela","Americas","c",2016,15,20,35
"Vietnam","Asia","c",2016,3,17,20
"West Bank","Middle East","t",2016,6,24,30
"Western Sahara","Africa","t",2016,-3,7,4
"Yemen","Middle East","c",2016,4,13,17
"Zambia","Africa","c",2016,26,34,60
"Zimbabwe","Africa","c",2016,12,20,32
"Abkhazia","Eurasia","t",2015,18,23,41
"Afghanistan","Asia","c",2015,11,13,24
"Albania","Europe","c",2015,27,40,67
"Algeria","Africa","c",2015,11,23,34
"Andorra","Europe","c",2015,39,57,96
"Angola","Africa","c",2015,10,18,28
"Antigua and Barbuda","Americas","c",2015,31,49,80
"Argentina","Americas","c",2015,31,49,80
"Armenia","Eurasia","c",2015,16,30,46
"Australia","Asia","c",2015,39,58,97
"Austria","Europe","c",2015,38,58,96
"Azerbaijan","Eurasia","c",2015,6,14,20
"Bahamas","Americas","c",2015,38,58,96
"Bahrain","Middle East","c",2015,5,10,15
"Bangladesh","Asia","c",2015,21,29,50
"Barbados","Americas","c",2015,40,59,99
"Belarus","Eurasia","c",2015,4,10,14
"Belgium","Europe","c",2015,40,57,97
"Belize","Americas","c",2015,36,51,87
"Benin","Africa","c",2015,32,49,81
"Bhutan","Asia","c",2015,29,27,56
"Bolivia","Americas","c",2015,29,39,68
"Bosnia and Herzegovina","Europe","c",2015,23,37,60
"Botswana","Africa","c",2015,28,45,73
"Brazil","Americas","c",2015,33,48,81
"Brunei","Asia","c",2015,7,23,30
"Bulgaria","Europe","c",2015,33,46,79
"Burkina Faso","Africa","c",2015,9,36,45
"Burundi","Africa","c",2015,11,21,32
"Cabo Verde","Africa","c",2015,37,53,90
"Cambodia","Asia","c",2015,11,20,31
"Cameroon","Africa","c",2015,9,16,25
"Canada","Americas","c",2015,39,59,98
"Central African Republic","Africa","c",2015,0,6,6
"Chad","Africa","c",2015,5,16,21
"Chile","Americas","c",2015,39,56,95
"China","Asia","c",2015,2,15,17
"Colombia","Americas","c",2015,29,34,63
"Comoros","Africa","c",2015,25,30,55
"Congo (Brazzaville)","Africa","c",2015,7,23,30
"Congo (Kinshasa)","Africa","c",2015,9,16,25
"Costa Rica","Americas","c",2015,37,53,90
"Cote d'Ivoire","Africa","c",2015,17,29,46
"Crimea","Eurasia","t",2015,-1,11,10
"Croatia","Europe","c",2015,36,50,86
"Cuba","Americas","c",2015,1,13,14
"Cyprus","Europe","c",2015,37,56,93
"Czech Republic","Europe","c",2015,38,57,95
"Denmark","Europe","c",2015,40,58,98
"Djibouti","Africa","c",2015,9,19,28
"Dominica","Americas","c",2015,38,57,95
"Dominican Republic","Americas","c",2015,30,43,73
"Ecuador","Americas","c",2015,24,35,59
"Egypt","Africa","c",2015,8,18,26
"El Salvador","Americas","c",2015,35,40,75
"Equatorial Guinea","Africa","c",2015,1,7,8
"Eritrea","Africa","c",2015,1,2,3
"Estonia","Europe","c",2015,39,56,95
"Eswatini","Africa","c",2015,1,17,18
"Ethiopia","Africa","c",2015,7,11,18
"Fiji","Asia","c",2015,26,34,60
"Finland","Europe","c",2015,40,60,100
"France","Europe","c",2015,38,57,95
"Gabon","Africa","c",2015,9,25,34
"Gaza Strip","Middle East","t",2015,5,10,15
"Georgia","Eurasia","c",2015,26,38,64
"Germany","Europe","c",2015,39,57,96
"Ghana","Africa","c",2015,37,47,84
"Greece","Europe","c",2015,35,48,83
"Grenada","Americas","c",2015,38,51,89
"Guatemala","Americas","c",2015,24,31,55
"Guinea","Africa","c",2015,17,24,41
"Guinea-Bissau","Africa","c",2015,17,23,40
"Guyana","Americas","c",2015,30,41,71
"Haiti","Americas","c",2015,17,24,41
"Honduras","Americas","c",2015,20,29,49
"Hong Kong","Asia","t",2015,16,49,65
"Hungary","Europe","c",2015,32,50,82
"Iceland","Europe","c",2015,39,60,99
"India","Asia","c",2015,35,43,78
"Indian Kashmir","Asia","t",2015,22,29,51
"Indonesia","Asia","c",2015,30,34,64
"Iran","Middle East","c",2015,7,10,17
"Iraq","Middle East","c",2015,11,13,24
"Ireland","Europe","c",2015,39,58,97
"Israel","Middle East","c",2015,36,44,80
"Italy","Europe","c",2015,36,53,89
"Jamaica","Americas","c",2015,34,40,74
"Japan","Asia","c",2015,39,55,94
"Jordan","Middle East","c",2015,11,25,36
"Kazakhstan","Eurasia","c",2015,6,18,24
"Kenya","Africa","c",2015,22,29,51
"Kiribati","Asia","c",2015,36,55,91
"Kosovo","Europe","c",2015,23,29,52
"Kuwait","Middle East","c",2015,14,23,37
"Kyrgyzstan","Eurasia","c",2015,14,24,38
"Laos","Asia","c",2015,1,11,12
"Latvia","Europe","c",2015,34,51,85
"Lebanon","Middle East","c",2015,14,30,44
"Lesotho","Africa","c",2015,30,41,71
"Liberia","Africa","c",2015,26,30,56
"Libya","Africa","c",2015,8,15,23
"Liechtenstein","Europe","c",2015,39,59,98
"Lithuania","Europe","c",2015,38,53,91
"Luxembourg","Europe","c",2015,38,60,98
"Madagascar","Africa","c",2015,22,30,52
"Malawi","Africa","c",2015,27,34,61
"Malaysia","Asia","c",2015,19,27,46
"Maldives","Asia","c",2015,20,28,48
"Mali","Africa","c",2015,17,27,44
"Malta","Europe","c",2015,39,58,97
"Marshall Islands","Asia","c",2015,36,55,91
"Mauritania","Africa","c",2015,9,22,31
"Mauritius","Africa","c",2015,38,52,90
"Mexico","Americas","c",2015,28,36,64
"Micronesia","Asia","c",2015,37,56,93
"Moldova","Eurasia","c",2015,28,35,63
"Monaco","Europe","c",2015,31,57,88
"Mongolia","Asia","c",2015,36,50,86
"Montenegro","Europe","c",2015,27,44,71
"Morocco","Africa","c",2015,15,27,42
"Mozambique","Africa","c",2015,23,35,58
"Myanmar","Asia","c",2015,9,16,25
"Nagorno-Karabakh","Eurasia","t",2015,12,18,30
"Namibia","Africa","c",2015,30,46,76
"Nauru","Asia","c",2015,37,51,88
"Nepal","Asia","c",2015,24,27,51
"Netherlands","Europe","c",2015,40,59,99
"New Zealand","Asia","c",2015,39,58,97
"Nicaragua","Americas","c",2015,19,35,54
"Niger","Africa","c",2015,26,30,56
"Nigeria","Africa","c",2015,18,25,43
"North Korea","Asia","c",2015,0,3,3
"North Macedonia","Europe","c",2015,23,37,60
"Northern Cyprus","Europe","t",2015,32,47,79
"Norway","Europe","c",2015,40,60,100
"Oman","Middle East","c",2015,9,17,26
"Pakistan","Asia","c",2015,20,22,42
"Pakistani Kashmir","Asia","t",2015,9,20,29
"Palau","Asia","c",2015,37,55,92
"Panama","Americas","c",2015,35,47,82
"Papua New Guinea","Asia","c",2015,23,36,59
"Paraguay","Americas","c",2015,27,38,65
"Peru","Americas","c",2015,30,41,71
"Philippines","Asia","c",2015,26,37,63
"Poland","Europe","c",2015,38,55,93
"Portugal","Europe","c",2015,39,58,97
"Puerto Rico","Americas","t",2015,37,52,89
"Qatar","Middle East","c",2015,10,18,28
"Romania","Europe","c",2015,34,49,83
"Russia","Eurasia","c",2015,7,16,23
"Rwanda","Africa","c",2015,9,16,25
"Samoa","Asia","c",2015,32,49,81
"San Marino","Europe","c",2015,40,60,100
"Sao Tome and Principe","Africa","c",2015,34,47,81
"Saudi Arabia","Middle East","c",2015,3,7,10
"Senegal","Africa","c",2015,33,45,78
"Serbia","Europe","c",2015,31,49,80
"Seychelles","Africa","c",2015,25,42,67
"Sierra Leone","Africa","c",2015,28,37,65
"Singapore","Asia","c",2015,19,32,51
"Slovakia","Europe","c",2015,37,53,90
"Slovenia","Europe","c",2015,38,53,91
"Solomon Islands","Asia","c",2015,25,43,68
"Somalia","Africa","c",2015,0,2,2
"Somaliland","Africa","t",2015,21,25,46
"South Africa","Africa","c",2015,33,48,81
"South Korea","Asia","c",2015,34,50,84
"South Ossetia","Eurasia","t",2015,1,9,10
"South Sudan","Africa","c",2015,2,13,15
"Spain","Europe","c",2015,39,57,96
"Sri Lanka","Asia","c",2015,16,25,41
"St. Kitts and Nevis","Americas","c",2015,37,53,90
"St. Lucia","Americas","c",2015,39,53,92
"St. Vincent and the Grenadines","Americas","c",2015,36,54,90
"Sudan","Africa","c",2015,2,4,6
"Suriname","Americas","c",2015,33,44,77
"Sweden","Europe","c",2015,40,59,99
"Switzerland","Europe","c",2015,39,57,96
"Syria","Middle East","c",2015,-3,2,-1
"Taiwan","Asia","c",2015,37,51,88
"Tajikistan","Eurasia","c",2015,7,15,22
"Tanzania","Africa","c",2015,28,35,63
"Thailand","Asia","c",2015,8,25,33
"The Gambia","Africa","c",2015,7,13,20
"Tibet","Asia","t",2015,-2,3,1
"Timor-Leste","Asia","c",2015,29,36,65
"Togo","Africa","c",2015,18,29,47
"Tonga","Asia","c",2015,31,44,75
"Transnistria","Eurasia","t",2015,10,14,24
"Trinidad and Tobago","Americas","c",2015,33,48,81
"Tunisia","Africa","c",2015,36,43,79
"Turkey","Europe","c",2015,26,29,55
"Turkmenistan","Eurasia","c",2015,1,5,6
"Tuvalu","Asia","c",2015,37,57,94
"Uganda","Africa","c",2015,11,25,36
"Ukraine","Eurasia","c",2015,25,37,62
"United Arab Emirates","Middle East","c",2015,8,13,21
"United Kingdom","Europe","c",2015,40,57,97
"United States","Americas","c",2015,37,55,92
"Uruguay","Americas","c",2015,40,58,98
"Uzbekistan","Eurasia","c",2015,0,4,4
"Vanuatu","Asia","c",2015,32,47,79
"Venezuela","Americas","c",2015,13,22,35
"Vietnam","Asia","c",2015,3,17,20
"West Bank","Middle East","t",2015,6,25,31
"Western Sahara","Africa","t",2015,-2,7,5
"Yemen","Middle East","c",2015,9,16,25
"Zambia","Africa","c",2015,26,34,60
"Zimbabwe","Africa","c",2015,12,16,28
"Abkhazia","Eurasia","t",2014,18,22,40
"Afghanistan","Asia","c",2014,11,15,26
"Albania","Europe","c",2014,27,40,67
"Algeria","Africa","c",2014,11,23,34
"Andorra","Europe","c",2014,39,57,96
"Angola","Africa","c",2014,11,18,29
"Antigua and Barbuda","Americas","c",2014,31,49,80
"Argentina","Americas","c",2014,31,49,80
"Armenia","Eurasia","c",2014,14,29,43
"Australia","Asia","c",2014,39,58,97
"Austria","Europe","c",2014,38,58,96
"Azerbaijan","Eurasia","c",2014,6,16,22
"Bahamas","Americas","c",2014,38,58,96
"Bahrain","Middle East","c",2014,6,10,16
"Bangladesh","Asia","c",2014,24,29,53
"Barbados","Americas","c",2014,40,59,99
"Belarus","Eurasia","c",2014,4,10,14
"Belgium","Europe","c",2014,40,57,97
"Belize","Americas","c",2014,36,51,87
"Benin","Africa","c",2014,32,48,80
"Bhutan","Asia","c",2014,28,27,55
"Bolivia","Americas","c",2014,29,38,67
"Bosnia and Herzegovina","Europe","c",2014,24,37,61
"Botswana","Africa","c",2014,28,46,74
"Brazil","Americas","c",2014,33,48,81
"Brunei","Asia","c",2014,7,23,30
"Bulgaria","Europe","c",2014,31,47,78
"Burkina Faso","Africa","c",2014,17,36,53
"Burundi","Africa","c",2014,12,22,34
"Cabo Verde","Africa","c",2014,37,53,90
"Cambodia","Asia","c",2014,10,20,30
"Cameroon","Africa","c",2014,8,16,24
"Canada","Americas","c",2014,39,59,98
"Central African Republic","Africa","c",2014,0,6,6
"Chad","Africa","c",2014,5,16,21
"Chile","Americas","c",2014,39,56,95
"China","Asia","c",2014,2,15,17
"Colombia","Americas","c",2014,28,34,62
"Comoros","Africa","c",2014,25,30,55
"Congo (Brazzaville)","Africa","c",2014,7,23,30
"Congo (Kinshasa)","Africa","c",2014,9,11,20
"Costa Rica","Americas","c",2014,37,53,90
"Cote d'Ivoire","Africa","c",2014,17,28,45
"Croatia","Europe","c",2014,36,50,86
"Cuba","Americas","c",2014,1,11,12
"Cyprus","Europe","c",2014,37,55,92
"Czech Republic","Europe","c",2014,37,57,94
"Denmark","Europe","c",2014,40,58,98
"Djibouti","Africa","c",2014,9,20,29
"Dominica","Americas","c",2014,38,57,95
"Dominican Republic","Americas","c",2014,30,43,73
"Ecuador","Americas","c",2014,24,36,60
"Egypt","Africa","c",2014,9,22,31
"El Salvador","Americas","c",2014,35,42,77
"Equatorial Guinea","Africa","c",2014,1,7,8
"Eritrea","Africa","c",2014,1,2,3
"Estonia","Europe","c",2014,39,56,95
"Eswatini","Africa","c",2014,1,19,20
"Ethiopia","Africa","c",2014,7,11,18
"Fiji","Asia","c",2014,7,30,37
"Finland","Europe","c",2014,40,60,100
"France","Europe","c",2014,38,57,95
"Gabon","Africa","c",2014,9,25,34
"Gaza Strip","Middle East","t",2014,5,10,15
"Georgia","Eurasia","c",2014,25,38,63
"Germany","Europe","c",2014,39,57,96
"Ghana","Africa","c",2014,37,47,84
"Greece","Europe","c",2014,35,48,83
"Grenada","Americas","c",2014,38,51,89
"Guatemala","Americas","c",2014,24,32,56
"Guinea","Africa","c",2014,17,24,41
"Guinea-Bissau","Africa","c",2014,9,23,32
"Guyana","Americas","c",2014,31,41,72
"Haiti","Americas","c",2014,18,25,43
"Honduras","Americas","c",2014,20,31,51
"Hong Kong","Asia","t",2014,16,51,67
"Hungary","Europe","c",2014,36,52,88
"Iceland","Europe","c",2014,40,60,100
"India","Asia","c",2014,34,43,77
"Indian Kashmir","Asia","t",2014,20,29,49
"Indonesia","Asia","c",2014,30,34,64
"Iran","Middle East","c",2014,7,10,17
"Iraq","Middle East","c",2014,12,13,25
"Ireland","Europe","c",2014,39,58,97
"Israel","Middle East","c",2014,36,45,81
"Italy","Europe","c",2014,37,53,90
"Jamaica","Americas","c",2014,34,40,74
"Japan","Asia","c",2014,37,53,90
"Jordan","Middle East","c",2014,11,24,35
"Kazakhstan","Eurasia","c",2014,6,19,25
"Kenya","Africa","c",2014,22,31,53
"Kiribati","Asia","c",2014,36,55,91
"Kosovo","Europe","c",2014,17,26,43
"Kuwait","Middle East","c",2014,16,23,39
"Kyrgyzstan","Eurasia","c",2014,14,25,39
"Laos","Asia","c",2014,1,11,12
"Latvia","Europe","c",2014,33,51,84
"Lebanon","Middle East","c",2014,16,32,48
"Lesotho","Africa","c",2014,31,41,72
"Liberia","Africa","c",2014,26,33,59
"Libya","Africa","c",2014,21,20,41
"Liechtenstein","Europe","c",2014,39,59,98
"Lithuania","Europe","c",2014,37,53,90
"Luxembourg","Europe","c",2014,39,60,99
"Madagascar","Africa","c",2014,15,28,43
"Malawi","Africa","c",2014,26,34,60
"Malaysia","Asia","c",2014,19,28,47
"Maldives","Asia","c",2014,19,29,48
"Mali","Africa","c",2014,17,27,44
"Malta","Europe","c",2014,39,58,97
"Marshall Islands","Asia","c",2014,36,55,91
"Mauritania","Africa","c",2014,11,23,34
"Mauritius","Africa","c",2014,38,52,90
"Mexico","Americas","c",2014,28,37,65
"Micronesia","Asia","c",2014,37,56,93
"Moldova","Eurasia","c",2014,29,35,64
"Monaco","Europe","c",2014,31,57,88
"Mongolia","Asia","c",2014,36,50,86
"Montenegro","Europe","c",2014,27,45,72
"Morocco","Africa","c",2014,15,27,42
"Mozambique","Africa","c",2014,23,35,58
"Myanmar","Asia","c",2014,9,17,26
"Nagorno-Karabakh","Eurasia","t",2014,12,19,31
"Namibia","Africa","c",2014,30,46,76
"Nauru","Asia","c",2014,38,54,92
"Nepal","Asia","c",2014,23,27,50
"Netherlands","Europe","c",2014,40,59,99
"New Zealand","Asia","c",2014,39,58,97
"Nicaragua","Americas","c",2014,19,35,54
"Niger","Africa","c",2014,26,30,56
"Nigeria","Africa","c",2014,20,26,46
"North Korea","Asia","c",2014,0,3,3
"North Macedonia","Europe","c",2014,26,38,64
"Northern Cyprus","Europe","t",2014,32,47,79
"Norway","Europe","c",2014,40,60,100
"Oman","Middle East","c",2014,9,17,26
"Pakistan","Asia","c",2014,21,21,42
"Pakistani Kashmir","Asia","t",2014,8,21,29
"Palau","Asia","c",2014,37,55,92
"Panama","Americas","c",2014,35,47,82
"Papua New Guinea","Asia","c",2014,24,36,60
"Paraguay","Americas","c",2014,26,35,61
"Peru","Americas","c",2014,30,41,71
"Philippines","Asia","c",2014,26,37,63
"Poland","Europe","c",2014,38,55,93
"Portugal","Europe","c",2014,39,58,97
"Puerto Rico","Americas","t",2014,37,52,89
"Qatar","Middle East","c",2014,10,18,28
"Romania","Europe","c",2014,35,49,84
"Russia","Eurasia","c",2014,7,19,26
"Rwanda","Africa","c",2014,9,17,26
"Samoa","Asia","c",2014,32,49,81
"San Marino","Europe","c",2014,40,60,100
"Sao Tome and Principe","Africa","c",2014,34,47,81
"Saudi Arabia","Middle East","c",2014,3,7,10
"Senegal","Africa","c",2014,33,46,79
"Serbia","Europe","c",2014,30,48,78
"Seychelles","Africa","c",2014,25,42,67
"Sierra Leone","Africa","c",2014,29,38,67
"Singapore","Asia","c",2014,19,32,51
"Slovakia","Europe","c",2014,37,54,91
"Slovenia","Europe","c",2014,38,53,91
"Solomon Islands","Asia","c",2014,22,43,65
"Somalia","Africa","c",2014,0,2,2
"Somaliland","Africa","t",2014,21,25,46
"South Africa","Africa","c",2014,33,48,81
"South Korea","Asia","c",2014,35,50,85
"South Ossetia","Eurasia","t",2014,-3,8,5
"South Sudan","Africa","c",2014,8,16,24
"Spain","Europe","c",2014,39,57,96
"Sri Lanka","Asia","c",2014,16,26,42
"St. Kitts and Nevis","Americas","c",2014,37,53,90
"St. Lucia","Americas","c",2014,39,53,92
"St. Vincent and the Grenadines","Americas","c",2014,36,53,89
"Sudan","Africa","c",2014,2,5,7
"Suriname","Americas","c",2014,33,44,77
"Sweden","Europe","c",2014,40,59,99
"Switzerland","Europe","c",2014,39,57,96
"Syria","Middle East","c",2014,-2,3,1
"Taiwan","Asia","c",2014,36,52,88
"Tajikistan","Eurasia","c",2014,8,16,24
"Tanzania","Africa","c",2014,29,35,64
"Thailand","Asia","c",2014,22,32,54
"The Gambia","Africa","c",2014,7,14,21
"Tibet","Asia","t",2014,-2,3,1
"Timor-Leste","Asia","c",2014,29,34,63
"Togo","Africa","c",2014,18,29,47
"Tonga","Asia","c",2014,31,44,75
"Transnistria","Eurasia","t",2014,10,14,24
"Trinidad and Tobago","Americas","c",2014,33,48,81
"Tunisia","Africa","c",2014,27,36,63
"Turkey","Europe","c",2014,28,32,60
"Turkmenistan","Eurasia","c",2014,1,6,7
"Tuvalu","Asia","c",2014,37,57,94
"Uganda","Africa","c",2014,11,26,37
"Ukraine","Eurasia","c",2014,20,35,55
"United Arab Emirates","Middle East","c",2014,8,13,21
"United Kingdom","Europe","c",2014,40,57,97
"United States","Americas","c",2014,37,55,92
"Uruguay","Americas","c",2014,40,58,98
"Uzbekistan","Eurasia","c",2014,0,4,4
"Vanuatu","Asia","c",2014,32,47,79
"Venezuela","Americas","c",2014,14,24,38
"Vietnam","Asia","c",2014,3,17,20
"West Bank","Middle East","t",2014,7,24,31
"Western Sahara","Africa","t",2014,-2,7,5
"Yemen","Middle East","c",2014,10,16,26
"Zambia","Africa","c",2014,25,34,59
"Zimbabwe","Africa","c",2014,12,16,28
"Abkhazia","Eurasia","t",2013,18,22,40
"Afghanistan","Asia","c",2013,11,16,27
"Albania","Europe","c",2013,24,39,63
"Algeria","Africa","c",2013,11,24,35
"Andorra","Europe","c",2013,39,57,96
"Angola","Africa","c",2013,11,19,30
"Antigua and Barbuda","Americas","c",2013,31,49,80
"Argentina","Americas","c",2013,31,49,80
"Armenia","Eurasia","c",2013,13,29,42
"Australia","Asia","c",2013,39,58,97
"Austria","Europe","c",2013,38,58,96
"Azerbaijan","Eurasia","c",2013,6,17,23
"Bahamas","Americas","c",2013,38,58,96
"Bahrain","Middle East","c",2013,6,12,18
"Bangladesh","Asia","c",2013,25,31,56
"Barbados","Americas","c",2013,40,59,99
"Belarus","Eurasia","c",2013,4,10,14
"Belgium","Europe","c",2013,40,57,97
"Belize","Americas","c",2013,37,51,88
"Benin","Africa","c",2013,32,50,82
"Bhutan","Asia","c",2013,22,24,46
"Bolivia","Americas","c",2013,29,40,69
"Bosnia and Herzegovina","Europe","c",2013,25,37,62
"Botswana","Africa","c",2013,28,46,74
"Brazil","Americas","c",2013,33,48,81
"Brunei","Asia","c",2013,7,23,30
"Bulgaria","Europe","c",2013,34,47,81
"Burkina Faso","Africa","c",2013,17,36,53
"Burundi","Africa","c",2013,12,22,34
"Cabo Verde","Africa","c",2013,37,53,90
"Cambodia","Asia","c",2013,9,20,29
"Cameroon","Africa","c",2013,7,16,23
"Canada","Americas","c",2013,40,58,98
"Central African Republic","Africa","c",2013,16,19,35
"Chad","Africa","c",2013,5,16,21
"Chile","Americas","c",2013,39,57,96
"China","Asia","c",2013,2,15,17
"Colombia","Americas","c",2013,27,34,61
"Comoros","Africa","c",2013,25,30,55
"Congo (Brazzaville)","Africa","c",2013,7,22,29
"Congo (Kinshasa)","Africa","c",2013,9,11,20
"Costa Rica","Americas","c",2013,38,53,91
"Cote d'Ivoire","Africa","c",2013,13,21,34
"Croatia","Europe","c",2013,36,50,86
"Cuba","Americas","c",2013,1,10,11
"Cyprus","Europe","c",2013,38,55,93
"Czech Republic","Europe","c",2013,38,57,95
"Denmark","Europe","c",2013,40,58,98
"Djibouti","Africa","c",2013,9,20,29
"Dominica","Americas","c",2013,38,57,95
"Dominican Republic","Americas","c",2013,31,44,75
"Ecuador","Americas","c",2013,24,36,60
"Egypt","Africa","c",2013,16,25,41
"El Salvador","Americas","c",2013,35,42,77
"Equatorial Guinea","Africa","c",2013,1,7,8
"Eritrea","Africa","c",2013,1,2,3
"Estonia","Europe","c",2013,39,56,95
"Eswatini","Africa","c",2013,1,20,21
"Ethiopia","Africa","c",2013,7,11,18
"Fiji","Asia","c",2013,7,30,37
"Finland","Europe","c",2013,40,60,100
"France","Europe","c",2013,38,57,95
"Gabon","Africa","c",2013,9,25,34
"Gaza Strip","Middle East","t",2013,9,10,19
"Georgia","Eurasia","c",2013,24,36,60
"Germany","Europe","c",2013,39,57,96
"Ghana","Africa","c",2013,37,47,84
"Greece","Europe","c",2013,35,48,83
"Grenada","Americas","c",2013,38,51,89
"Guatemala","Americas","c",2013,24,33,57
"Guinea","Africa","c",2013,15,24,39
"Guinea-Bissau","Africa","c",2013,7,23,30
"Guyana","Americas","c",2013,31,40,71
"Haiti","Americas","c",2013,19,24,43
"Honduras","Americas","c",2013,18,33,51
"Hong Kong","Asia","t",2013,16,51,67
"Hungary","Europe","c",2013,36,52,88
"Iceland","Europe","c",2013,40,60,100
"India","Asia","c",2013,34,42,76
"Indian Kashmir","Asia","t",2013,20,29,49
"Indonesia","Asia","c",2013,30,35,65
"Iran","Middle East","c",2013,6,10,16
"Iraq","Middle East","c",2013,11,13,24
"Ireland","Europe","c",2013,39,58,97
"Israel","Middle East","c",2013,36,45,81
"Italy","Europe","c",2013,35,53,88
"Jamaica","Americas","c",2013,33,40,73
"Japan","Asia","c",2013,37,51,88
"Jordan","Middle East","c",2013,10,24,34
"Kazakhstan","Eurasia","c",2013,6,20,26
"Kenya","Africa","c",2013,21,34,55
"Kiribati","Asia","c",2013,36,55,91
"Kosovo","Europe","c",2013,16,26,42
"Kuwait","Middle East","c",2013,17,24,41
"Kyrgyzstan","Eurasia","c",2013,14,25,39
"Laos","Asia","c",2013,0,11,11
"Latvia","Europe","c",2013,33,51,84
"Lebanon","Middle East","c",2013,17,32,49
"Lesotho","Africa","c",2013,31,41,72
"Liberia","Africa","c",2013,26,34,60
"Libya","Africa","c",2013,22,21,43
"Liechtenstein","Europe","c",2013,39,59,98
"Lithuania","Europe","c",2013,37,53,90
"Luxembourg","Europe","c",2013,40,60,100
"Madagascar","Africa","c",2013,7,28,35
"Malawi","Africa","c",2013,26,34,60
"Malaysia","Asia","c",2013,20,28,48
"Maldives","Asia","c",2013,17,29,46
"Mali","Africa","c",2013,5,19,24
"Malta","Europe","c",2013,39,58,97
"Marshall Islands","Asia","c",2013,36,55,91
"Mauritania","Africa","c",2013,11,23,34
"Mauritius","Africa","c",2013,38,52,90
"Mexico","Americas","c",2013,28,37,65
"Micronesia","Asia","c",2013,37,56,93
"Moldova","Eurasia","c",2013,29,36,65
"Monaco","Europe","c",2013,31,56,87
"Mongolia","Asia","c",2013,36,50,86
"Montenegro","Europe","c",2013,27,45,72
"Morocco","Africa","c",2013,16,27,43
"Mozambique","Africa","c",2013,23,36,59
"Myanmar","Asia","c",2013,9,17,26
"Nagorno-Karabakh","Eurasia","t",2013,12,19,31
"Namibia","Africa","c",2013,30,46,76
"Nauru","Asia","c",2013,38,55,93
"Nepal","Asia","c",2013,20,27,47
"Netherlands","Europe","c",2013,40,59,99
"New Zealand","Asia","c",2013,39,58,97
"Nicaragua","Americas","c",2013,17,34,51
"Niger","Africa","c",2013,26,30,56
"Nigeria","Africa","c",2013,20,26,46
"North Korea","Asia","c",2013,0,3,3
"North Macedonia","Europe","c",2013,26,38,64
"Northern Cyprus","Europe","t",2013,32,46,78
"Norway","Europe","c",2013,40,60,100
"Oman","Middle East","c",2013,9,17,26
"Pakistan","Asia","c",2013,20,22,42
"Pakistani Kashmir","Asia","t",2013,8,21,29
"Palau","Asia","c",2013,37,55,92
"Panama","Americas","c",2013,36,46,82
"Papua New Guinea","Asia","c",2013,23,36,59
"Paraguay","Americas","c",2013,27,35,62
"Peru","Americas","c",2013,30,41,71
"Philippines","Asia","c",2013,26,37,63
"Poland","Europe","c",2013,38,55,93
"Portugal","Europe","c",2013,39,58,97
"Puerto Rico","Americas","t",2013,37,52,89
"Qatar","Middle East","c",2013,10,18,28
"Romania","Europe","c",2013,32,49,81
"Russia","Eurasia","c",2013,7,20,27
"Rwanda","Africa","c",2013,8,16,24
"Samoa","Asia","c",2013,32,49,81
"San Marino","Europe","c",2013,40,60,100
"Sao Tome and Principe","Africa","c",2013,34,47,81
"Saudi Arabia","Middle East","c",2013,3,7,10
"Senegal","Africa","c",2013,32,43,75
"Serbia","Europe","c",2013,30,48,78
"Seychelles","Africa","c",2013,25,42,67
"Sierra Leone","Africa","c",2013,30,40,70
"Singapore","Asia","c",2013,19,33,52
"Slovakia","Europe","c",2013,37,55,92
"Slovenia","Europe","c",2013,38,53,91
"Solomon Islands","Asia","c",2013,22,43,65
"Somalia","Africa","c",2013,0,2,2
"Somaliland","Africa","t",2013,21,25,46
"South Africa","Africa","c",2013,34,47,81
"South Korea","Asia","c",2013,36,50,86
"South Ossetia","Eurasia","t",2013,-3,8,5
"South Sudan","Africa","c",2013,11,20,31
"Spain","Europe","c",2013,39,57,96
"Sri Lanka","Asia","c",2013,16,27,43
"St. Kitts and Nevis","Americas","c",2013,38,53,91
"St. Lucia","Americas","c",2013,39,54,93
"St. Vincent and the Grenadines","Americas","c",2013,36,53,89
"Sudan","Africa","c",2013,2,5,7
"Suriname","Americas","c",2013,33,44,77
"Sweden","Europe","c",2013,40,60,100
"Switzerland","Europe","c",2013,39,57,96
"Syria","Middle East","c",2013,-1,6,5
"Taiwan","Asia","c",2013,36,52,88
"Tajikistan","Eurasia","c",2013,8,16,24
"Tanzania","Africa","c",2013,28,38,66
"Thailand","Asia","c",2013,22,31,53
"The Gambia","Africa","c",2013,7,16,23
"Tibet","Asia","t",2013,-2,3,1
"Timor-Leste","Asia","c",2013,29,34,63
"Togo","Africa","c",2013,16,27,43
"Tonga","Asia","c",2013,29,44,73
"Transnistria","Eurasia","t",2013,10,15,25
"Trinidad and Tobago","Americas","c",2013,33,48,81
"Tunisia","Africa","c",2013,26,33,59
"Turkey","Europe","c",2013,28,33,61
"Turkmenistan","Eurasia","c",2013,1,6,7
"Tuvalu","Asia","c",2013,37,57,94
"Uganda","Africa","c",2013,12,28,40
"Ukraine","Eurasia","c",2013,21,36,57
"United Arab Emirates","Middle East","c",2013,8,14,22
"United Kingdom","Europe","c",2013,40,57,97
"United States","Americas","c",2013,37,56,93
"Uruguay","Americas","c",2013,39,58,97
"Uzbekistan","Eurasia","c",2013,0,4,4
"Vanuatu","Asia","c",2013,32,47,79
"Venezuela","Americas","c",2013,15,24,39
"Vietnam","Asia","c",2013,2,17,19
"West Bank","Middle East","t",2013,6,24,30
"Western Sahara","Africa","t",2013,-2,7,5
"Yemen","Middle East","c",2013,9,16,25
"Zambia","Africa","c",2013,28,34,62
"Zimbabwe","Africa","c",2013,11,14,25
